Major Lazer - Know No Better feat. Travis Scott, Camila Cabello & Quavo
Halsey - Bad At Love
Fifth Harmony - Down feat. Gucci Mane
Arcade Fire - Everything Now
Lorde - Perfect Places
All Time Low - Good Times
Meek Mill - Whatever You Need feat. Chris Brown & Ty Dolla $ign
Hearts & Colors - Shame
Foo Fighters - Run
Paramore - Fake Happy (Edit)
Halsey - Alone
PARTYNEXTDOOR - Rendezvous
Dua Lipa - New Rules
Yo Gotti - Rake It Up feat. Nicki Minaj
Robotaki - Monkey Bars feat. Claire Ridgely
Phoenix - Goodbye Soleil
Seeb & Greg Holden - Boys In The Street
Tritonal - Wild Kind feat. Varpu
Ashe - Used To It
Snakehips - Right Now feat. ELHAE, D.R.A.M. & H.E.R
Alt-J - Deadcrush
Liam Gallagher - Wall Of Glass
Bleachers - All My Heroes
RL Grime - Stay For It feat. Miguel
Vanic - Staring At The Sun feat. Clara Mae
Alok- Love Is A Temple feat. IRO
Terror Jr - Appreciation
Absofacto - Endless Summer
Terence Ryan - To Live and Die in New England
Joywave - Shutdown
Portugal. The Man - So Young
Alec Benjamin - I Built a Friend
Bakermat - Don't Want You Back feat. Kiesza
Ne-Yo - Another Love Song
LANY - 13
The Japanese House - Somebody You Found
Halsey - Hopeless feat. Cashmere Cat
The War On Drugs - Holding On
Great Good Fine Ok - Find Yourself feat. Before You Exit
NEW CITY - Dirty Secrets
A.CHAL - Love N Hennessy
August Alsina - Don't Matter
Mali Music - Loved By You feat. Jazmine Sullivan
J Balvin & Jowell & Randy - Bonita
2 Chainz - 4 AM feat. Travis Scott
Smokepurpp - To The Moon
Ansel Elgort - You Can Count On Me feat. Logic
Bea Miller - buy me diamonds
Hey Violet - O.D.D
Olly Murs - Unpredictable feat. Louisa Johnson
HEDEGAARD - Go Back feat. Hayley Warner
VÉRITÉ - Saint
Mike Floss - Take Yours
Molly Kate Kestner - I Don't Know
Meg Mac - Maybe It's My First Time
Luke Combs - When It Rains It Pours
Elton John & Jack White - 2 Fingers of Whiskey
Dan Auerbach - Malibu Man
Dispatch - Painted Yellow Lines
R3hab & Skytech - Marrakech
Duke Dumont & Gorgon City - Real Life feat. Naations
Why Don't We - Why Don't We Just
Halsey - Devil In Me
Nause - Summer Hangover feat. OMVR
Alice Kristiansen - Lost My Mind
Beach Fossils - Tangerine
Mags Duval - Plain Jane
Cosmos & Creature - Bad Drug
Peking Duk & AlunaGeorge - Fake Magic
H.E.R. - Lights On
Amber Coffman - City of No Reply
Hillsong United - Shape Of Your Heart
Cody Lovaas - Bodies
Lo Moon - This is It