Ed Sheeran - American Town
PinkPantheress - Mosquito
Jung Kook - 3D (feat. Jack Harlow)
Latto - ISSA PARTY (feat. BabyDrill)
The Rolling Stones & Lady Gaga - Sweet Sounds Of Heaven
Feid - LUCES DE TECNO
Lil Wayne & Cool & Dre - To The Bank
Thomas Rhett - Mamaw's House
*NSYNC & Justin Timberlake - Better Place
U2 - Atomic City
6LACK & Jessie Reyez - Homicide
Cleo Sol - Desire
Tyga, YG & Lil Wayne - Brand New
Oliver Tree - With You
Jorja Smith - Broken is the man
hemlocke springs - pos
Empress Of & Rina Sawayama - Kiss Me
Rick Ross & Meek Mill - SHAQ & KOBE
Becky G - 2NDO CHANCE
Jax Jones - Won't Forget You
Chase Atlantic - MAMACITA
John Summit & VLTRA (IT) - Legacy
AJR - YÐµs I'm A Mess
IVE - Either Way
YoungBoy NevÐµr Broke Again - Testimony
Sexyy Red - Shake Yo Dreads
Slow Pulp - MUD
JVKE - this is what space feels like
Flyana Boss - Big One
Ne-Yo - Link Up
Del Water Gap - NFU
LANY - Out Of My League
Enrique Iglesias & MarÃ­a Becerra - ASI ES LA VIDA
Jonah Kagen - Pollution
Brenn! - Rearview
Lyrical Lemonade, Lil Durk & Kid Cudi - Guitar In My Room
Glorilla, Fivio Foreign & CMG The Label - Cha Cha Cha
Eliza Rose - Take You There
XG - PUPPET SHOW
Jeremy Zucker - this time
Dustin Lynch - Honky Tonk Heartbreaker
Bruce Springsteen - Addicted to Romance
quannnic - How to Hold a Knife
Dean Lewis - Trust Me Mate
Walker Hayes - New Money
Flatland Cavalry & Kaitlin Butts - Mornings With You
Ricky Montgomery - Truth or Dare
Destroy Lonely - catch a kill
BIA - RAISE THE STAKES
Kenyon Dixon - 2000s R&B
Blonde Redhead - Sit Down for Dinner, Pt. 2
Tyler Cole & Baby Tate - I Don't Wanna Dance
DaBaby - TRICKIN'
Le Youth - Morning Light
Two Door Cinema Club - Sure Enough
Lani Rose - Sink or Swim (SOS)
Dahi & Elmiene - Shame
Anne Wilson - Rain In The Rearview
Mae Muller - Nervous (In A Good Way)
Amaria - Day by Day - A COLORS SHOW
NEIKED - You're Hired (feat. Ayra Starr)
Sam Gellaitry - UNDER THE ILLUSION
REI AMI - body bag
Code Orange - Snapshot
Peezy & BabyTron - Psilocybin
Maxo Kream - Whatchamacallit (feat. Luh Tyler)
Victony - Jaga Jaga (feat. Babyboy AV)
Oneohtrix Point Never - Memories Of Music
Sum 41 - Landmines
julie - catalogue
Say She She - QuestionsðŸ•’
DOPE LEMON - Derby Raceway
Jade Eagleson - Telluride
Ivan Theva - Gardens
William Prince - I Want It That Way - Spotify SinglesðŸ•’
Thomas Day - I Don't Wanna Leave Just Yet
44phantom - f.u.n!
Yaeger - Ciao
LP Giobbi - Time Expands
LEISURE - Last Dance
Zacari - Reverse
TOBi - Someone I Knew
LP - Dayglow
Brittney Spencer - Bigger Than The Song
Josh Ross - Ain't The One
Goldie Boutilier - White Limo Stuck in The Snow
Addison Grace - Pessimistic
Jack Kays - Feel Like Me
Wilco - Levee
Baerd - It's All Happening Now
No Guidnce - Spicy
Skilla Baby - Bae
Armand Hammer - The Gods Must Be Crazy
ISOxo - STARsound
Spencer Elmer - Everytime (feat. Capo Lee)ðŸ•’
Flwr Chyld & Sebastian Mikael - EucalyptusðŸ•’
Cherry Glazerr - Bad Habit
HONEYMOAN - Pickup, Don't Pickup
DEBBY FRIDAY - let u in