Kygo - I'm In Love feat. James Vincent McMorrow
Ariana Grande - Let Me Love You feat. Lil Wayne
Lucas Nord - Don't Need Your Love
Flume - Say It feat. Tove Lo
Meghan Trainor - Better feat. Yo Gotti
Contact - Never Stop
Sara Hartman - Satellite
Jon Bellion - Guillotine feat. Travis Mendes
Fetty Wap - Wake Up
Little Mix - Hair feat. Sean Paul
Monopol - Somebody That I'll Never Be
Loop - Looking at You
Fort Frances - Days Get Heavy
With You. - Ghost feat. Vince Staples (Major Lazer Remix)
NF - I Just Wanna Know
A$AP Ferg - World is Mine feat. Big Sean
Slushii - Emptiness
King Arthur - Talking About Love feat. Trm
Girl Friend - Nocturnal
Moose Blood - Honey
PVRIS - You and I (Stripped)
Lonely the Brave - Rattlesnakes
ELEL - Animal
White Sea - Bloodline
Bahari - Dancing on the Sun
A. Sinclair - Let It Go
Enrique Iglesias - Duele El Corazon feat. Wisin
Deorro - Bailar feat. Elvis Crespo
Big Black Delta - Bitten by the Apple feat. Kimbra
Harrison - LA Girls feat. Juicy M
Kllo - Bolide
Jesiah - Babylon
Erik Jonasson - Like a Funeral
Clare Maguire - The Valley
The Kills - Heart of a Dog
Great American Canyon Band - Only You Remain
Charlotte Day Wilson - Work
The Hearts - Lovers Drug
Mako - Into the Sunset
Matoma - Wonderful Life (Mi Oh My)
Atmosphere - Fireflies feat. Grieves
Giungla - Sand
Twin Peaks - Holding Roses
Amber Mark - Space
Kendra Foster - Promise to Stay Here feat. Kelvin Wooten1