Russ - Missin You Crazy
Hozier - Nina Cried Power - edit (featuring Mavis Staples)
The Blaze - QUEENS
Lauren Daigle - Look Up Child
Logic - Everybody Dies
Paul McCartney - Happy With You
Kanye West - I Love It (& Lil Pump)
Steve Aoki & Nicky Romero - Be Somebody (feat. Kiiara)
Alice Merton - Why So Serious
YBN Almighty Jay & YBN Nahmir - New Drip (feat. Gucci Mane)
Jillian Jacqueline - Priorities
Dua Lipa - Want To
Darlingside - Hold Your Head up High - Recorded at Spotify Studios, NYC
Gavin James - Glow
Trill Sammy - I Can't Decide (feat. Offset)
Chelsea Cutler - Cold Showers
Jeremy Zucker - comethru
Jagwar Twin - Loser
Phora - Love Is Hell (feat. Trippie Redd)
MK, Jonas Blue, & Becky Hill - Back & Forth
T.I. - Jefe (feat. Meek Mill)
Carrie Underwood - End Up With You
Lukas Graham - Love Someone
Tom Morello - Lucky One (feat. K.Flay)
Noah Cyrus - Mad at You (with Gallant)
Zigmeister - Insomnia
Kane Brown - Homesick
The Marías - Clueless
Amber Mark - Put You On
Robinson - Medicine
KIDDO - Drunk And I Miss You (feat. Decco)
Rvssian, Farruko, & J Balvin - Ponle
Sasha Sloan - The Only
Yung Gravy - Pizzazz
DREAMERS - The Last Love Song
$uicideBoy$ - Nicotine Patches
The O'My's - Idea
Castlecomer - Leaving
The Score - Stronger
MKTO - How Can I Forget
Hazey Eyes - Scars
Kilo Kish - San Pedro
Baby E - Trapper Of The Year
MØ - Way Down
Wingtip - Fake It
Hunter Hayes - Attention - Recorded at Woodshed Recording Malibu
Sakehands - PLASTIC
Clairo - Heaven
Sigala, Ella Eyre, & Meghan Trainor - Just Got Paid
Masego - Queen Tings
Sylvan Esso - Funeral Singers
Majid Jordan - All Over You
Chloe Lilac - Summer
The Faim - Make Believe
Jessie Reyez - Fuck Being Friends
Ruston Kelly - Blackout
Boston Manor - England's Dreaming
AlunaGeorge - Superior Emotion
Berner - Light Show (feat. Kevin Gates)
Novo Amor - Utican
David Guetta & CeCe Rogers - Freedom
De La Ghetto - Caliente (feat. J Balvin)
Elle King - Good Thing Gone
GRAACE - Last Night
MNEK - Body
Maribou State - Kingdom
Greta Van Fleet - Watching Over
Young & Sick - Sleepyhead
Supa Bwe - Entropy (feat. Dounia)
Mosaic MSC - Never Let Me Down
K E M A L - BRAVE
Emmit Fenn & Drew Love - Without You
Brynn Elliott - Internet You
Roosevelt - Getaway
Alvaro Soler - Te Quiero Lento
Basement - Disconnect
Phony Ppl - Way Too Far.
Lauren Aquilina - Psycho
Julia Holter - I Shall Love 2
The Night Game - The Photograph
Parcels - Lightenup
Naji - Trust Issues
Beartooth - Manipulation
Abby Anderson - I'm Good
Derek Minor & Canon - It's Not a Game
Arlie - water damage
Mac Ayres - Next to You
Charlie Puth - The Way I Am - Slushii Remix
Men I Trust - Seven
Barrie - Michigan
Iman Omari - Another
Dizzee Rascal - Money Right
Carl Broemel - Wished Out
Death By Shotgun - Lines
Just Loud - Diamonds and Dope Boys
Bones Owens - White Lines1