SZA - Kill Bill (feat. Doja Cat)
Dominic Fike - Dancing In The Courthouse
Marshmello & Farruko - Esta Vida
NLE Choppa - TALK DIFFERENT
Ice Spice & Nicki Minaj - Princess Diana
Jorja Smith - Try Me
Kelly Clarkson - mine
Diplo - Use Me (Brutal Hearts) (feat. Sturgill Simpson, Dove Cameron & Johnny Blue Skies)
d4vd - Sleep Well
Kodak Black - No Love For A Thug
YoungBoy Never Broke Again - Rear View (feat. Mariah The Scientist)
Lewis Capaldi - Wish You The Best
David Kushner - Daylight
MEDUZA - Upside Down (feat. Poppy Baskcomb)
Metallica - Too Far Gone?
Brett Young - Dance With You
King Krule - Sеaforth
Charlotte Cardin - Confetti
Eladio Carrion,Anuel AA - Tristе Verano
IVE - I AM
Rainbow Kitten Surprise - Drop Stop Roll
Lauren Spencer Smith, GAYLE & Em Beihold – Fantasy
Fivio Foreign - Hot Sauce
OHGEESY - Chrome Hearted (feat. Tyga)
Khamari - Right My Wrongs
Megan Moroney - Girl in the Mirror
Benson Boone - What Was
Frost Children – WONDERLAND (feat. Blaketheman1000 & May Rio) 🐚
Romy - Enjoy Your Life
The National - Your Mind Is Not Your Friend (feat. Phoebe Bridgers)
Feist - The Redwing
Dinner Party - Can't Go (feat. Phoelix)
Magdalena Bay - Top Dog
Saba & No I.D. - Back In Office
halfBREED - Vroom Vroom
Quinn XCII - Georgia Peach
Caitlyn Smith - Alaska
Vacations - Next Exit
Surfaces - Thankful
Conexión Divina & Gabito Ballesteros - Paso A Pasito
Waterparks - 2 BEST FRIENDS
Rick Ross,Fat Joe & The LOX - The Game
Yung Bleu & Chris Brown - Distant Lover
Bazzi - Eyes
Aidan Bissett - Out Of My League
Abraham Alexander - Déjà Vu (ft. Mavis Staples) 🐚
Shygirl - Crush feat. Erika de Casier
B-Lovee,2Rare - Act Bad 🐚
Josh Levi - EGO
Jonas Blue & RANI - Finally
James Carter & Ofenbach - Can’t Forget You (feat. James Blunt)
Sarah Kinsley - Oh No Darling!
PÆRISH - Houses of American Style 🐚
Tee Grizzley & Skilla Baby - Dropped The Lo 🐚
Pi’erre Bourne - Lessons
Cannons - Loving You
Caloncho & Cuco - Medusa
Crumb - Crushxd
Jessie Ware - Begin Again - Single Edit
Jengi - Nothing Is Easy 🐚
Zoe Wees - Don't Give Up
rum.gold - AM/FM 🐚
ELEVATION RHYTHM & Joe L Barnes - This Is The Gospel
Balance And Composure - Savior Mode
Ray Laurél & Jeshi - DONTLEAVEMYSIDE 🐚
JELEEL! - WICKED!
DD Osama- 4148 (feat. Edot Babyy & Lawsy) 🐚
The Linda Lindas - Too Many Things
aldn - pressure (feat. chloe moriondo)
Mackenzie Carpenter - Throw You Back 🐚
LAUREL - Change
Sam Short - Hooked
carolesdaughter - nobody's favorite person, not even my own 🐚
Amir Obe - TALK TO ME NICE (feat. PARTYNEXTDOOR & G. Ry)
Doe Boy - ROLL THE DICE (feat. DeJ Loaf)
Michaël Brun, Masego & Jozzy - Charge It (feat. Bayka) 🐚
DJ Big N,Ayra Starr,Oxlade - How Many Times 🐚
Lola Indigo & Quevedo - EL TONTO
Whyte Fang - Deep End
Joel Corry & Billen Ted - Do U Want Me Baby? (feat. Elphi)
Miya Folick - So Clear 🐚
Dylan Conrique - pieces
Eloise - I Take It Back 🐚
Jelly Roll & Yelawolf – Unlive
The Tallest Man On Earth - Looking For Love
Parker McCollum - Tails I Lose
ROSIE - Someone You Once Had
TALK - Afraid of the Dark🐚
Hozwal - Súbelo & Bájalo (feat. Wisin & Alexis) 🐚
Tommy Royale - Mellow 🐚
Gloss Up - La La 🐚
Jean Deaux - Yeah Yeah 🐚
Shenseea - Curious
Groupthink & KennyHoopla - Dancing On My Grave 🐚
Michl & Brandon - Everytime the Night Starts Calling 🐚
Sam MacPherson - First Place
Kara Jackson - lily
Kai Bosch - Spider 🐚
Jaz Karis - THERAPY 🐚