Melanie Martinez - VOID
boygenius - Cool About It
JISOO - FLOWER
Chl√∂e,Future - Cheatback
Marshmello, Polo G & Southside - Grown Man
Becky G & Peso Pluma - Chanel
Charlie Puth - That‚Äôs Not How This Works (feat. Dan + Shay)
Daniel Caesar - Valentina
DJ Drama - Free Game (feat. Lil Uzi Vert & 42 Dugg)
Quavo - Honey Bun
Q - NOT ALONE
Khalid - Softest Touch
Gucci Mane - 06 Gucci (feat. DaBaby & 21 Savage)
Tyler, The Creator - WHARF TALK (feat. A$AP Rocky)
Bebe Rexha - Call on Me
Maisie Peters - Lost The Breakup
IVE - Kitsch
Kygo - Say Say Say (feat. Paul McCartn–µy & Michael Jackson)
Armin van Buuren & Punctual - On & On (feat. Alika)
F–µid,Young Miko - Classy 101
Nardo Wick - Hot Boy (feat. Lil Baby)
Rod Wave - Fight The Feeling
Jhen√© Aiko - calm & patient
charlieonnafriday & Lil Tjay - Same Friends
Ellie Goulding - Cure For Love
Cat Burns - live more & love more
Jesse¬Æ - Rainbow
Chappell Roan - Kaleidoscope
Lauren Daigle - Waiting
Larry June & The Alchemist - Summer Reign (feat. Ty Dolla $ign)
Jhayco - Cuerpecito
Uncle Waffles, Tony Duardo & Justin99 - Yahyuppiyah (feat. Pcee, EeQue, Chley) ‚òëÔ∏è
Popcaan - Celebrate (feat. Black Sherif) ‚òëÔ∏è
nothing,nowhere. - VEN0M (feat. UNDEROATH)
Alexander 23 - I Wanna Live Forever
Cian Ducrot - Part Of Me
Barrie - Ghost World
Yahritza Y Su Esencia - No Se Puede Decir Adi√≥s
Darius Rucker - Fires Don't Start Themselves
Rich The Kid - Yeh Yeh (feat. Rema, Ayra Starr & KDDO)
Jay Wheeler - Xexo
YONAKA - Welcome to My House
NATTI NATASHA - ALGARETE
Wiz Khalifa - Peace and Love
G-Eazy - Tulips & Roses
Purple Disco Machine & Kungs - Substitution
Jungle - Candle Flame (feat. Erick the Architect)
spill tab - Window
Georgia - It‚Äôs Euphoric
IMRSQD - Taxi üêö
Billianne - Full Circle
Bryan Martin - Poets & Old Souls (feat. Frank Foster)
King Isis - im fine, thx 4 asking
Giant Rooks - Bubble Gum - Spotify Singles
MisterWives - Out Of Your Mind
Icona Pop - Faster
Shay Lia - TAKUT√Å
Curren$y, Jermaine Dupri & T.I. - Never Fall Off
Morray - High Price (feat. Lil Tjay)
Kenyon Dixon - Slow Dancing (feat. Kincy) üêö
Michigander - Cannonball
Josh Ross - Red Flags
Charlotte Lawrence - Bodybag
Tones And I - I Am Free
The Smashing Pumpkins - Spellbinding
Royel Otis - Going Kokomo
Olivia Dean - Dive
Jess Williamson - Hunter
be your own PET - Hand Grenade
Metallica - 72 Seasons
Paris Texas - PANIC!!!
Luh Tyler - Weeks (feat. NoCap)
2Rare - Rare Steppa
THEY. - Riptide
Davido - UNAVAILABLE (feat. Musa Keys)
Elderbrook - I Need You
salute & Sammy Virji - Peach
Jayda G - Blue Lights
Dimitri Vegas, Steve Aoki & Chapter & Verse - Friends
Ozuna, Juanka & Brray - La Single
Real Boston Richey - 5 Star
REASON - At It Again‚òëÔ∏è
Lola Young - What Is It About Me
Lehla Samia - Care
Lloyiso - Give A Little Kindness
Caitlyn Smith - Mississippi
The Beths - Watching The Credits
Cloudy June - Love Under The Influence
Jenny Lewis - Psychos
Caylee Hammack - History Of Repeating
Homeschool - Loving You To Death
Johnny Goth - Everybody Just Wants To
CEO Trayle - Meant 4 You üêö
KenTheMan - Mean B*tch üêö
Dreamer Isioma - Touch Your Soul (feat. FAVE & Merlyn Wood)
BEL - Woman on Fire
Two Shell - ‚ú® mum is calling ‚ú®
AMAKA - Cruisin'
London Brew - It's One Of These