Bj√∂rk & ROSAL√çA - Oral
Myke Towers - LA FALDA
Sexyy Red - Free My N***a
Gucci Mane - Cold (feat. B.G. & Mike WiLL Made-It)
Tim McGraw - Runnin' Outta Love
Zara Larsson - Memory Lane
Eyedress - Sadie Hawkins Prom
Trippie Redd & YTB Fatt - Snail Shells
Diplo & HUGEL - Stay High
EKKSTACY - shutting me out
Danny Ocean - No te enamores de √©l
Jacob Collier - Witness Me (feat. Shawn Mendes, Stormzy & Kirk Franklin)
Jon Batiste - It Never Went Away
Meg McRee - Wildflower
Galantis & Hannah Boleyn - Little Bit Yours
Ryder - All Alone
Lay Bankz - Sloppy Seconds (Ick Pt. 2)
Rels B & Kenia Os- Por Dentro
Busta Rhymes - ROBOSHOTTA (feat. Burna Boy)
Snow Strippers - Just A Hint
Alvaro Diaz & Quevedo - QUIZ√ÅS SI QUIZ√ÅS NO
Oliver Heldens & WeiBird - Out of Love
Omarion - The Usual
James Arthur - Homecoming
Luh Tyler - Change My Wayz
Big Moochie Grape - Bars (feat. Rio Da Yung Og)
Victony - OHEMA (feat. Crayon & Bella Shmurda)
Henry Moodie - orbit
Sam Fischer - Hard to Love
RAAHiiM - Bodies
SoFaygo - WHAT YOU WANT
AViVA - HATE 2 LUV U
Elisapie - Love Is a Stranger - Spotify Singles
Lili-Ann De Francesco - the girl (that you can't get over)
Callista Clark - Diamond
Tom Rosenthal - My Body
Odeal & emil - Gave You My Allüïí
Kamaiyah - Lamborghini Dreams (feat. 03 Greedo)üïí
Big Yavo - Jet Lee
Ti√´sto & Da Hool - Meet Herüïí
Essosa - Tell Nobody
Morat - Sobreviviste
ELIO - A2B
Fetty Wap - Outside
Kali Claire - Wish You Wouldn'tüïí
Claudia Isaki - Un Dia
Ocie Elliott - Know the Night
Harrison Storm - Tomorrow
Brian Fuller - Tellin' On You
Kid Sistr - Books
Blaketheman1000 - Float On
B Jack$ - Project XXX
PARISI - Believe In Myselfüïí
Martin Jensen & MATTN - Still Got It Badüïí
Memphis LK - Black And Blue
Mia Nicolai - STUCK
Lime Cordiale - Pedestal
Jarrod Morris - Marlboros
Flozigg - Guarded Woman
Jace! - Surround Sound System
Che Ecru - Feel Dumb
Switch Disco - VACANCY
Spyres - Only This Could Happen To Me
Swansea Skag - gardenside
Yb. - BULLETPROOF
Keep Shelly In Athens - Lonely Times
Philip Brooks - to be all alone
Skrizzly Adams - Out of Towners
Major Nine & Kodak Black - Shawtyüïí
MEDUZA - Musica
Spencer Elmer - Crush (feat. Arz & Journey Montana)
Sody - Missing Me
The Japanese House - Super Trouper
Jess and Tay - Drinks With the Boys
Winona Oak - Fire Escapes
Lifesize Teddy - Unbeliever
Tink - 40x
Lil Maru - This Yo Song
CZARFACE - Czarchimedes‚Äô Death Ray
HEALTH - DEMIGODS
Goldielocks - East to South
Tim Atlas - The Deceiving
Jude York - Cheerleaders and Jocksüïí
Random Chance - LOVERS
april june - it's all my fault
j ember - Hummingbird
Liv Miraldi - Denver
mich4el - deep end
CHROMEBODIES - I Could Be (feat. valentina cy)
merci, mercy - If You Had Any Friends
Maisie May - All in <3
Sid Dorey - Family Reunion
canless valley - That's What They Wanted
Marisa McKaye - found it
Jack Boyd - Steep
Justend - michael myers
Orange House - Orange Squeeez
Apashe - Kingüïí
Snoop Dogg - Gz Up, Hoes Down