Chris Brown - Questions
Thomas Rhett - Grave
Cardi B - Bodak Yellow feat. Messiah Latin Trap Remix
ZHU & NERO - Dreams
Chase & Status - Crawling
Lil Peep - Save That Shit
Gucci Mane - I Get The Bag feat. Migos
A R I Z O N A - Cross My Mind Pt. 2 feat. Kiiara
Chelsea Cutler - You Make Me
Miley Cyrus - Younger Now
CNCO & Little Mix - Reggaetón Lento (Remix)
Maisie Peters - Place We Were Made
Ryan Follese - Lose A Little Sleep
Rachel Platten - Broken Glass
Buddy - Type Of Shit feat. Wiz Khalifa
Pale Waves - Television Romance
Xuitcasecity - Need Somebody
Secret Weapons - My Blue Heaven
Echosmith - Future Me
J. Roddy Walston & The Business - You Know Me Better
Grizzly Bear - Losing All Sense
Death From Above 1979 - Never Swim Alone
Bibi Bourelly - Untitled (In Studio)
Nothing But Thieves - I'm Not Made by Design
Jazz Cartier - Nobody's Watching
A$AP Ferg - Trap And A Dream feat. Meek Mill
Fetty Wap - There She Go (feat. Monty)
Kodak Black - My Klik feat. John Wicks & JackBoy
BAUM - Hot Water
LCD Soundsystem - tonite
Luke James - Drip
Anthony Russo - California
Leikeli47 - 2nd fiddle
Phora - Facts
Lizzo - Water Me
Skip Marley - Refugee
DVBBS - Cozee feat. Cisco Adler
OFFAIAH - Run This Town feat. Shenseea
Peewee Longway - His Name Cassius feat. PARTYNEXTDOOR
Dave East - Maneuver feat. French Montana
Petit Biscuit - Gravitation feat. Møme & Isaac Delusion
Perfume Genius - Slip Away (Recorded at Spotify Studios NYC)
Anderson East - All On My Mind
Weezer - Mexican Fender
Haux - Cologne
Toulouse - Hurtin
Amber Mark - Heatwave
Alice Glass - Blood Oath
Neck Deep - In Bloom1