Ty Dolla $ign & Future - Darkside feat. Kiiara
Somewhere Else - Uh Huh
Sigrid - Strangers
Jason Derulo - Tip Toe feat. French Montana
T-Pain - Textin' My Ex feat. Tiffany Evans
Alae - Too Strung Up
Empire of the Sun - On Our Way Home
G-Eazy - The Plan
EDEN - gold
6ix9ine - GUMMO
PnB Rock - Scrub
Taio Cruz - Row The Body feat. French Montana
NVDES - D.Y.T. (Do Your Thing) feat. REMMI
BC Unidos - Trouble in the Streets feat. Carly Rae Jepsen
Kim Petras - Slow It Down
Petit Biscuit - Problems feat. Lido
YUNGBLUD - Tin Pan Boy
London Richards - Far Away
Rich Chigga - Crisis feat. 21 Savage
Ernest K. - Trouble With Us
WALK THE MOON - Kamikaze
Spencer - Whatever
Luna Bay - Little Amsterdam
Fake Pictures - Small Talk feat. Tiger Park
Greta Van Fleet - Edge Of Darkness
NAV - Wanted You feat. Lil Uzi Vert
Rad Horror - Dark Times
Bastille - World Gone Mad
Gladius James - Too Bad
Maisie Peters - Birthday
Two Feet - I Feel Like I'm Drowning
Ashe - Girl Who Cried Wolf
Wiz Khalifa - Letterman
Xuitcasecity - Shadows
Ten FÃ© - Single, No Return
AWOLNATION - Seven Sticks of Dynamite
Fuse ODG - Boa Me feat. Ed Sheeran & Mugeez
Jennifer Lopez - Amor, Amor, Amor feat. Wisin
Pitbull & Stereotypes - Jungle feat. E-40 & Abraham Mateo
Timeflies - Semi-Charmed
CupcakKe - Cartoons
Sampa the Great - Black Girl Magik feat. Nicole Gumbe
Baker Grace - Day I Die
Kailee Morgue - Medusa (Chet Porter Remix)
Jidenna - Boomerang
SHY Martin - Good Together
Ella Vos - I Know You Care
Pale Waves - New Year's Eve
Seeb & Skip Marley - Cruel World
Tennis - Diamond Rings
Chromeo - Juice
Flight Facilities - Stranded feat. Broods, Reggie Watts & Saro
Sleigh Bells - Favorite Transgressions
Pell - chirpin'
Cousin Stizz - Lace Up
Felix Snow - Tender Buffalo
NSTASIA - Parachute
Kesha - Learn To Let Go (Michael Brun Remix)
Jennifer Lopez - Vivir Mi Vida (Recorded at Spotify Studios NYC)
Sir Rosevelt - Something 'Bout You
Mavi Phoenix - Janet Jackson
Kidswaste & Manila Killa - Tonight
Chuck Adams - Take Me As I Am
Vera - Nobody Else