Dytto & Shanin Blake - "Energy Vampires (Remix)"
Ewa Lodzik - "Policjantka"
Original God - "Sporting Goods" ft. Yung Bambi

6/3
Cigarettes After Sex - "Baby Blue Movie"
Snowd4y - "Wah Gwan Delilah" ft. Drake

6/4
Ashton Irwin - "Straight To Your Heart"
Brezden - "Puerto Rico"
Halsey - "The End"
IC3PEAK - "Ненавижу"
Hardo - "No Time Soon" ft. B Dok
Kiki Rockwell - "Syrena"
Poppy - "New Way Out"
6/5
Andy Grammer - "Without You"
Chrissy Chlapecka - "Sugar"
Denzel Curry, TiaCorine & A$AP Ferg - "HOT ONE"
Larry June - "Dreams"
Los - "BOOTLEG KEV FREESTYLE"
Moses Sumney - "Vintage"
6/6
Lucas Estrada, Lost Ways & Eirik Næss - "Remember This"
Luke Combs - "The Man He Sees in Me"
Rich Dunk - "BIG DAWG" ft. DaBaby
Sabrina Carpenter - "Please Please Please"
Tyga - "Hello B*tch"
Welshly Arms - "Dreamers"
Xanderman - "While We're Still Breathing"
6/7
Amanda Jordan - "Tonight I Am"
Bay Swag - "Nothing Last Forever"
BIA & JID - "LIGHTS OUT"
Cash Cobain - "Rump Punch"
Cel NoLackin - "Southside"
Chris August - "God Is Good"
Danielle Bradbery - "Broken Boy"
French Montana & Skilla Baby - "Skyami"
Headie One - "I Still Know Better"
Karley Scott Collins - "Write One" ft. Keith Urban
Koe Wetzel - "High Road" ft. Jessie Murph
Latto - "Sunday Service (Remix)" ft. Megan Thee Stallion & Flo Milli
Lil Darius - "Unthinkable"
Little Big Town & Kelsea Ballerini - "Shut Up Train (Collab Version)"
Mae Estes - "Gettin' Back Up To Heaven"
Marshmello & Sabrina Claudio - "Don't Speak"
Martin Garrix & DubVision - "Wherever You Are" ft. Shaun Farrugia
Mickey Guyton - "Make It Me"
Mitchell Tenpenny - "Iris"
Moneybagg Yo - "PLAY DA FOOL"
Nathan Dawe & MNEK - "Ten (Get Back Up)"
Nicky Youre - "Tease Me"
Omar Apollo - "Less of You"
Orville Peck, Kylie Minogue & Diplo - "Midnight Ride"
Peso Peso & Sauce Walka - "Movin' 2 Fast"
Pitbull - "2 The Moon" ft. Ne-Yo & Afrojack
R3HAB & Jason Derulo - "Animal (R3HAB VIP Remix)"
RAYE - "Genesis"
RIELL - "8 Years Old"
Rosa Linn - "Universe (French Version)" ft. JECK
SoFaygo - "Life So Crazy"
Swedish House Mafia & Niki & The Dove - "Lioness"
Tay B - "SheSheMe" ft. Skilla Baby
The Vamps - "Somebody To You (ReVamped)"
Thomas Rhett - "Gone Country"
Tori Kelly - "All I Want"
Tucker Wetmore - "Already Had It"
YG - "SHAKE" ft. Kaliii & Stunna Girl
Yung Gravy & Shania Twain - "White Claw"
zxmra - "let me love you"
6/8
NoCap - "Baby Drake"
6/11
Calboy - "Need Your Love"
Jensen McRae - "Massachusetts"
YTB Fatt - "Get Up On It"
6/12
Jelly Roll - "I Am Not OK"
Tony K - "Villain" ft. Reem

6/13
BossMan Dlow - "SportsCenter"
Judah & the Lion - "Measure of a Man" ft. JOSEPH
Zoe Osama - "Stomp"
6/14
Becky Hill & ZERB - "Outside Of Love (Zerb Remix)"
Billy Currington - "Everything Is Changing"
Bôa - "Worry"
cassö & Jazzy - "Zeros" ft. Headie One
BKAYE & ayokay - "Somewhere"
D Sturdy, PGS Spence & 2Rare - "Let Me Jump In"
Fivio Foreign - "SUVY THEATERS"
Haley Osier & Chase Coy - "Wish You Were Here"
Jake Miller - "Mini You"
Jessica Sanchez - "Honest"
Jordan Davis & NEEDTOBREATHE - "Banks"
Jordan Davis & NEEDTOBREATHE - "Buy Dirt"
KB Mike - "Villians"
kurtains - "just not sure" ft. glaive
Liana Banks & Saweetie - "GPP"
Lil Crix - "Murda Man"
Lil Tony Official - "Just For Fun"
Luke Bryan - "Mind Of A Country Boy"
Macy Gray & Big Freedia - "I AM"
Ne-Yo - "2 Secrets"
Pharrell Williams - "Double Life"
Quavo - "Mink"
Rob49 - "Off Dat Drank"
Said The Sky & BOYS LIKE GIRLS - "Hold My Breath"
Shordie Shordie - "Outside"
Tanner Adell - "Too Easy"
Tommy Richman - "DEVIL IS A LIE"
Toosii - "Where You Been"
6/15
MTM DonDon - "Striker"
6/17
1Up Tee - "Butt Naked"
DaBoii - "Fresh Out The County"
Tones and I - "Dance With Me"
6/18
Bielzin - "Nivus" ft. Chefin
seamoretheseal - "Botch"
6/19
BabyDrill - "Dracula"
FCG Heem - "What a Time To Be Alive"
MOTHICA - "Toxins"
6/20
FTO Sett - "Keep It Quiet"
Lainey Wilson - "Out of Oklahoma"
Shoreline Mafia - "Work"
THEY. - "Diamonds And Pearls"
6/21
1Up Tee & STAR BANDZ - "Click"
2Rare - "Congratulationz"
Adam Lambert - "CVNTY"
Alec Benjamin - "Found You First"
Alex Sampson - "Pretty Baby"
Alice Glass - "Remains" ft. CLIP
Alok & Jess Glynne - "Summer's Back"
Ariana Grande - "​the boy is mine (Remix)" ft. Brandy & Monica
Ayesha Erotica - "House Party"
Baby Bugs - "Baby, Baby" ft. Solya
Babyfxce E - "Yung OG Flow"
Bay Swag - "Worldwide Sniper"
Bilmuri & Knox - "2016 CAVALIERS (Ohio)"
gavn! - "Jealous Guy"
Brantley Gilbert - "Over When We're Sober" ft. Ashley Cooke
Cascada - "Call Me"
Chase Rice - "Go Down Singin'"
Corey Kent - "Never Ready"
Dua Lipa - "Illusion (The Blaze Remix)"
Fridayy - "Baddest In The Room"
GloRilla - "TGIF"
Headie One - "Tipsy" ft. Aitch
Hend Collin - "Flying High"
Ice Spice - "Phat Butt"
Icewear Vezzo & Peezy - "Aight"
IDK - "TiFFANY" ft. Gunna
Jelly House - "Rizz"
KA1D - "I Don't Get It"
Kali Uchis - "Never Be Yours (2024 Version)"
Lil Darius - "Like My Daddy"
Maren Morris & Julia Michaels - "cut!"
Masicka - "20 Matic"
MICO - "HOMESICK"
Mustard & Travis Scott - "Parking Lot"
NIKI - "Blue Moon"
Paris Hilton & Rina Sawayama - "I'm Free"
Post Malone - "Pour Me A Drink" ft. Blake Shelton
Quin NFN - "Loose Lips"
Rich the Kid & Kanye West - "Gimme a Second 2"
RJmrLA & Siete7x - "Whole Head"
Rudimental & Karen Harding - "Bring Me Joy"
Sauce Walka - "Where My Soda?" ft. YTB Fatt
$NOT - "HILARIOUS" ft. Cochise
Skrilla - "Matte Black"
Tee Grizzley - "Robbery 7"
The Astronomers & sammy rash - "co-star"
Tre Loaded - "Don't Panic"
Tyga & 310babii - "Uh Huh"
WILD - "Getting Started"
YUNGBLUD - "breakdown."
Zedd & Bea Miller - "Out of Time"
6/23
Lil Darkie - "TENHO QUE COMER" ft. EF & Ugovhb
Yungeen Ace - "Do It"
6/24
Jdot Breezy - "Pysch'n Out"
SOPHIE - "Reason Why" ft. Kim Petras & BC Kingdom
Tyler Childers - "Song While You're Away"
6/25
42 Dugg - "N.P.O. ft. Sexyy Red
adore - "losing interest (work of art)"
DaBoii - "Lights Out"
Denzel Curry & That Mexican OT - "BLACK FLAG FREESTYLE"
MUDBABY RU - "Watch How You Step"
The Waeve - "You Saw"
6/26
Foster the People - "Take Me Back"
Lil Mabu - "BANG! BANG!"
Remble - "Colors" ft. Stoneda5th & Mozzy

6/27
Big One, Maria Becerra & Trueno -  "Cuando Te Vi CROSSOVER #5"
Burna Boy - "Higher"
Ha*Ash - "El Cielo Te Mandó para Mí"
LISA - "Rockstar"
Luar La L - "Perdida"
Ozuna, Anuel AA & DJ Luian - "Razones" ft. Mambo Kingz
Pamungkas - "New Feeling"
Roddy Ricch - "911"
Spice - "Round Round" ft. Busta Rhymes

6/28
Arian Cruz - "Lynette"
Ayesha Erotica & Baku - "Handjob"
Bebe Rexha - "I'm The Drama"
Brytiago, Jay Wheeler & iZaak - "Aura"
Clairo - "Nomad"
Crash Adams - "Hotel Party"
David Guetta & OneRepublic - "I Don't Wanna Wait (Acoustic)"
Daughtry - "NERVOUS"
Daya - "Don't Call"
Desire - "Dangerous Drug"
Flower Face - "Skeleton Key"
GAYLE - "Internet Baby"
Gryffin, Whethan & Norma Jean Martine - "Dance Through The Night"
James Charles - "Bring Me Water"
Jax Jones, Joel Corry & Jason Derulo - "Tonight (D.I.Y.A.)"
Jeremih, Bryson Tiller & Chris Brown - "Wait On It"
Keith Urban - "WILDSIDE"
Kelsea Ballerini & Noah Kahan - "Cowboys Cry Too"
Landon Cube - "Emerald Isle"
Latto - "Big Mama"
LAZER DIM 700 - "Futon"
Leah Kate – "What Girls Do"
Lil Crix - "Meal Ticket"
Lil Durk - "Went Hollywood For A Year"
Luh Tyler - "Handz Up"
Mason Ramsey - "All the Way to Memphis"
Mason Ramsey - "How Do I Know If I'm in Love"
midwxst - "GUN SMOKE"
Miranda Lambert - "Dammit Randy"
MOONEY - "Groceries"
Nelly Furtado, Tove Lo & SG Lewis - "Love Bites (Don Diablo Remix)"
Neoni - "Jump Rope"
Offset - "Style Rare" ft. Gunna
Ralo - "Swimming With Dolphins" ft. Kenny Muney, Big Moochie Grape & Goldmouf
Rich Amiri - "OUT MY MIND"
RJAE - "Put You Down"
Rob49 & Skilla Baby - "Homebody (Remix)" ft. Moneybagg Yo & BossMan Dlow
Rosa Linn & Denny - "Universe (Mil Jaana Tu)"
SCY Jimm - "Working With"
Sheck Wes - "BEAST"
Skepta & R2R Moe - "Miss Independent"
Sticky'Lo - "F*ck a Chain"
Sybyr - "Bad Habits"
The Astronomers & sammy rash - "rocketship"
The Kid LAROI - "GIRLS"
Tinashe - "Getting No Sleep"
Trippie Redd - "Bando Kid"
TyFontaine - "Only One"
Yungeen Ace - "Game Over"
6/29
Ayesha Erotica - "from the back"
Lil Poppa - "More To Life"