Rubberband - Tate McRae
Lifestyle (feat. Adam Levine) - Jason Derulo
Antes - Anuel AA
Ain't Got Time (feat. Fousheé) - Lil Wayne
Kash App (feat. Mulatto) - BRS Kash
Someone Else - Deb Never
21st Century Vampire - LILHUDDY
New Love (feat. Ellie Goulding) - Silk City
Safeword - Rhye
Egotism - Finn Askew
Pomegranate - Kota the Friend
LiLBiTcH (feat. Rico Nasty & Soleima) - chillpill
Skin - Sabrina Carpenter
Nasty (feat. Rubi Rose) - Rich Thе Kid
Rose Gold (feat. King Von) - PnB Rock
I Cannot Love You - Mario Judah
Dеad Broke - Lil Skies
American Dream - Willie Jones
Crash and Burn - Maggie Lindemann
Doodoodoo - Curtis Waters
Stars - PRETTYMUCH
Buck 50 - DJ Scheme
Girl Like You (with Sech & Tyga feat. J.I the Prince of N.Y) - Dímelo Flow
MLK Dr - Smino
Black Hole - Griff
CHARGER - ELIO
Cloak n dagger - glaive
Good Vibes (Za) - Wale
Sweet & Dandy - Tash Sultana
Drivers license - jxdn
New Wave - Bow Anderson
Anxious - Dennis Lloyd
Colors - Black Pumas
Ropa Cara - Camilo
Endless - Rence
Night Like This - daydream Masi
All My Favorite Songs - Weezer
Typhoons - Royal Blood
Ride Or Cry - Vacation Forever
Lost In America - Lo Village
Sunshine (The Light) - Fat Joe
Bubble Gum (with Yandel) - Lele Pons
Candyman - R3HAB
Reasons - Mimi Webb
Dance For The Hell Of It - LOVA
Tell Me I'm Pretty - Brynn Elliott
Devotion - The Staves
SHADES ON - Raissa
BAFFLEdd - SEBii
Neva Said It - Mozzy
Ghetto Love Birds - Yung Bleu
Rock bottom (feat. nothing,nowhere.) - guccihighwaters
Troubled Paradise - Slayyyter
Dance Alone - Boy In Space
What's the point? - beaux
Cazenove - Bicep
Castles - WYLDE
Gave That Back (feat. Baby Grizzley) - Tee Grizzley
Large Amounts - Young Dolph
Rosario - Epik High
Shoulda coulda woulda (feat. Deem Spencer & Torii Wolf) - Young Saab
Winter Rain - Winona Oak
I Just Wanna Be Loved - JORDY
So Pretty - Reyanna Maria
I'M SO SAD - 3OH!3
[Citizen (feat. Gary Clark Jr.) - Sir Sly]x
[Life I Live - Yungeen Ace]x
Re Route - Funkmaster Flex
Fool 4 U - ROE
Lucy - KALI
Superpowerful (with Crooked Colours) - slenderbodies
For a Reason - Natalie Taylor
Dead Boys - FLØRE
You A Dime - DJ Chose
Don't Drink Dasani - K CAMP
State of the Union - Marlon Craft
I Can't Lose - Erick the Architect
Here's ur chance - Damien
Sound off - 44phantom
Postmates - valentina cy
Call Me A Fool [Feat. Carla Thomas] - Valerie June
Don't Love a Girl - Dylan Brady
[Molasses (Walk The Walk) - Dylan Cartlidge]x
Surrender - Birdy
Sicko - CLOVES
[Throw That Back - DijahSB]x
Soldiers Steppin - Duke Deuce
[360 - Laney Keyz]x
Neon Diamonds - Lainey Wilson
WILDIN' - Ash Olsen
X - CHUNG HA
Everything - 3LAU
AIRDROP - Harry Nach
[Parallel Parking - Arden Jones]x
ACTION - CHAI
I NEED YOU - Jon Batiste
Fresh Wind - Hillsong Worship
Wilder Days - Morgan Wade
Darker Place - Rachel Chinouriri
Never Gonna Be The Same - Mia Wray