Billie Eilish - What Was I Made For?
KAROL G - S91
Troye Sivan - Rush
Jung Kook - Seven (feat. Latto) (Explicit Ver.)
Quavo & Future- Turn Yo Clic Up
Lil Tjay - Stressed (feat. Summer Walker)
Dan + Shay - Save Me The Trouble
PinkPantheress - Turn Your Phone Off
Disclosure - Higher Than Ever Before
King Von & Polo G - Phil Jackson
Ryan Castro, Peso Pluma & SOG - QUEMA
Lauren Spencer Smith - Bigger Person
glaive - 17250
Rene√© Rapp - Talk Too Much
Blxst & Remble - child of GOD
Mickey Guyton - Nothing Compares To You (Feat. Kane Brown)
Mahalia - In My Bag
Jon Batiste - Drink Water (feat. Jon Bellion and Fireboy DML)
J Hus - Militerian (feat. Naira Marley)
Nessa Barrett - hell is a teenage girl
PVRIS - I DON'T WANNA DO THIS ANYMORE
Thirty Seconds To Mars - Get Up Kid
Anuel AA & Quavo - Baby
DDG - Famous
City Girls & JT - No Bars
(G)I-DLE - I DO
Chelsea Cutler - I Don't Feel Alive
Sueco - Help Me
MisterWives - Sideways
Oxlade - INTOXYCATED (feat. Dave)
Tycho - Time To Runüïí
Becky Hill & Chase & Status - Disconnect
Residente - Bajo y Bater√≠a
Brothers Osborne - Sun Ain't Even Gone Down Yet
Colter Wall - Little Songs
Charlotte Cardin - Jim Carrey
Alana Springsteen - ghost in my guitar (feat. Chris Stapleton)
Rita Ora - You & I
Alan Walker & Zak Abel - Endless Summer
Robert Glasper - Back To Love (Feat. SiR & Alex Isley)
Sid Sriram - The Hard Way
Lil Gnar - PB&J
Eyedress - Teen Mom
Walter The Producer - Sweet Bonita
Zack Bia - Flowers (feat. Lil Yachty)
Joel Corry, Icona Pop & Rain Radio - Desire
Pryda - The Return - Edit
Adekunle Gold - Ogaranya
Sleepy Hallow - Good Girls Ain't No Fun
DJ Premier - Runway
Emei - Cynical
Ricky Montgomery - Black Fins
Jamila Woods - Tiny Garden
Chance Pe√±a - Lovers to Strangers
Wyatt Flores - Holes
Lukas Nelson and Promise of the Real - All Four Winds
Pink Sweat$ - Guitar
Maddie Zahm - Where Do All The Good Kids Go?
Hailey Whitters - I'm In Love
Dan Auerbach - Every Chance I Get (I Want You In The Flesh)
Claud - A Good Thing
Genesis Owusu - Tied Up!
Eem Triplin - WASTED TIMES
2Rare & NLE Choppa - Don't Run
JPEGMAFIA & Danny Brown - Guess What Bitch, We Back Hoe!
SIPHO. - SOBER
Tiago PZK - ASQUEROSO
NATHY PELUSO - SALVAJE
Mack Keane - Chances
Yussef Dayes - Marching Band (feat. Masego)üêö
Will Paquin - Lightning
Emotional Oranges & ZHU - Not Like This
NMIXX - Party O'Clock
Kevin de Vries - Metro
Odetari & 9lives - I LOVE YOU HOE
KYLE & Lay Bankz - WOAH
Mozzy - Count Time
KenTheMan - I Love A Freak
Charlotte Sands - Good Now
Palehound - Eye On The Bat
NEIL FRANCES - Let's Break It Down
Yard Act - The Trench Coat Museum
Alex Warren - Change Your Mind
Sons Of The East - Hard To Tell
Morgan Wade - 80's Movie
Blake Mills - Press My Luck
Jermaine Edwards - Higher
ASTN - Element
Rhea Raj - Oops! Ur Single Now
Tessa Violet - BAD BITCH
Kaleena Zanders & Anabel Englund - Anything 4 U
bludnymph & 6arelyhuman - Bizarre
Maiya The Don - Luv U Betterüïí
Dave East - HUSTLERS (feat. Tyga)
Berhana - Gone (Abebe Bikila)
maxime. - ‚Äétalk 2 ‚Äémeüïí
Hello Yello - Alone In December
Idman - Beach
wilo wilde - back in time