Derek Charles Johnson - "His Eye Is on the Sparrow" ⏳
King Koro - "Kingdom" feat. 1K Phew ⏳
Q-Flo - "Y.K.T.D" feat. Aable & Scribe Music ⏳
Poor Bishop Hooper - "Psalm 127"
Vision of Leo & Edgar Sandoval Jr - "BLEEDIN" ⏳6/2Fight The Fade - "Revival"
Intensifire - "Set It on Fire"
Jéssica Augusto - "Existe Vida Aí" ⏳
quiet thrill, Joel Ansett & Dan DeCristofaro - "open frame" ⏳6/3Alive City - "I Love You (Halee's Song)" ⏳
ANGEL!NA - "Red Eyes"
Angie Rose - "Fight Of Your Life"
Apex Frazier - "Pool Sharks" feat. DJ Mykaеl V
Awakening Worship - "Witnesses"
Bеn Lawrence & J.Steph - "GUIDE MY HEART"
Ben Trip - "Far Beyond" ⏳
Billy Ballenger - "Can't See It Yet"
bodie - "GHOST"
Built By Titan & Skybourne - "Wild World"
Christian Singleton & Preston Holland - "Invincible" ⏳
Citizens - "Imagination"
Courtnie Ramirez - "Walls"
Daniela Galeano - "U Love Me" ⏳
Demon Hunter - "FREEDOM IS DEAD"
D.Tall - "VEGAS" feat. Aha Gazelle ⏳
Dustin Starks - "Canvas" ⏳
Ecole Pierre - "Lumière dans le noir (Renaître)" ⏳
Elikem Kofi - "Joro Mi"
Ernstly Etienne - "A Time for Everything" ⏳
Faith Lofi - "loading" ⏳
Fearless BND - "Courageous" ⏳
Fear Not - "Fields of Sorrow"
Folabi Nuel - "More Than Enough (Live)" ⏳
Gaetan Judd - "long days long nights"
Gas Street Music - "Sacred Fire" feat. Luke Hellebronth
Gods Music - "Punchlines" feat. ATTAM, Pastor Charles A.R. & Q-Flo ⏳
Grace Union - "Only You"
Hinge Point - "Thank You Lord"
Jena Brancart - "First Love" ⏳
Jessé Aguiar - "Está Tudo Bem"
Jet Trouble - "Stubborn"
JJ Heller - "Weight in Gold" ⏳
J J L - "VINCE CARTER!" feat. Barely Trev, Cole Tindal & Nate Donk!
Joe Garza - "Speak Life" feat. Dennis Garman Jr. ⏳
John Michael Howell, Jude Barclay & Swaizy - "DEAR PETER PAN"
Jonathan Ogden - "Be Like You" feat. Darla Baltazar
Josh Wright - "Brother"
Liv Douglas - "Abundance"
L. Spenser Smith - "Never Forget (That's What He Is)" ⏳
Matt Maher - "My Old Friend" feat. Drew Holcomb
Maverick City Music & Kirk Franklin - "Bless Me"
MercyMe - "Then Christ Came"
Mike Teezy - "Can I Get A?"
Mitch Langley - "Child Of God" feat. Citizen Way ⏳
Nico Cabrera - "Me Consumes" ⏳
Noontides - "Outta This World"
Nu Tone - "Be A Legend" feat. Kaleb Mitchell & Ray Knowledge
O'Bros - "blessed"
Phil J - "Slave"
Redimi2 - "Rompiendo" ⏳
Red Tips - "Hit My Line" feat. YB
Ryan Ellis - "Lean On The Lord"
Ryan Ofei - "The Vow"
Sal Ly - "Lost In Your Vibe" ⏳
Sandra McCracken - "Thy Mercy, My God"
Seth Benjamin - "Rescued" ⏳
Setty - "Breathing Heavy" feat. NXTMIKE ⏳
SEU Worship - "Heart Cry" feat. Dan Rivera
Silent King - "The Curse"
Solarjet - "Hallo Hey" ⏳
Spencer Annis - "In the Upper Room"
Stephanie Haavik - "Already There" ⏳
Stephen McWhirter & Jason Clayborn - "Plans"
Stones of Eden - "Walk Through the Fire" ⏳
TB1, Moses Bliss & Kelly Lyon - "Akorede" ⏳
The Timbre of Cedar - "More"
TobyMac - "The Goodness" feat. Blessing Offor
Tom Endersby - "Soli Deo Gloria"
Tre'Gadd - "Thorn To a Daisy" ⏳
VOUS Worship - "Up On This Rock"
Worship For Everyone & Nick & Becky Drake - "Move"
ZDIORX - "FASHION" feat. DJ Mykael V & Torey D'Shaun ⏳6/4Chris Trent - "When I'm Not Around"
The Sown - "hidden in the Sun" feat. Daniel Soe & Joyce Soe ⏳6/5Christopher Gayle - "Never Change" ⏳
MARCO AZAUSKI - "Te Vi" ⏳6/6Jessé Aguiar - "O Amor Me Disse"6/7Eddie James & Fresh Wine Music - "Blood"
J. Monty - "Pray for Me"
John Lee - "No Place Like Home"
Thunderstorm Artis - "Take Me to the Fire"
Tracy Nitschke - "You Know"
VITOHRIA SOUNDS, Philipe Santos & Marcos Vinicius - "Quero Ir Mais Fundo" ⏳6/8JXHN PVUL & Anmily Brown - "Todo" ⏳
Poor Bishop Hooper - "Psalm 128"
Shiwan & Weez the Satellite Kiid - "Skate" ⏳
Sicology - "Too High (Remix)" feat. Bptheofficial, Isaiah Robin, Hunterdrinkswater, ZDIORX, Zae Ortiz, simplyollie ⏳
Tomi Favored - "Committed to You" feat. Suanesha ⏳6/9Igor Akulov - "Нам нужно встретиться" ⏳
TJ Carroll - "Free Smoke" ⏳6/10Alvin Cedric - "Not Letting it Go" feat. Joseph Goulding
Andrew Marcus - "Sweet Communion" feat. Chloé ⏳
Angeloh - "Thank God for You" feat. Still Shadey ⏳
Anthem Worship, Holly Halliwell & Mass Anthem - "Before Me" ⏳
Austin Ray Hardy - "He's Been There Every Time" ⏳
Avery Doreen - "Grace For That" ⏳
Bayside Worship - "We Will Never Stop (Live)"
Benji - "PTL"
Ben Laine - "Names"
BigGucciDame - "you are worth it" ⏳
Brad & Rebekah - "Glorious Hope"
Caleb Russel Kennedy - "Lead Me To The Rock That Is Higher Than I" ⏳
Cecily - "Smell The Roses"
Christy Nockels - "Abide"
Community Music - "Ruins (Live)"
David & Nicole Binion - "The Mighty Chorus" feat. John Wilds
Deep Valleys - "Another Story (Of How It Used to Be)" ⏳
Dillon Chase - "Wildflower" ⏳
Ed Williams - "Change" ⏳
Elijah Waters - "Only You" ⏳
Emily Brimlow - "Information Superhighway"
Faith Lofi - "holy spirit"
Glochi & TKE3 - "Right Here"
GOLDEN GOOSE - "Top O' The Mornin'"
Harborside Music - "By The Stripes"
Hope Darst - "If The Lord Builds The House"
Ian Osawaye - "Rest" feat. Slim Tyme ⏳
Influence Music - "Of Great Courage" feat. Larry James Walker II
In The Wild - "Only You" ⏳
Jae Young - "Like That" feat. nobigdyl. ⏳
John Lucas - "My Constellation" ⏳
Josiah Queen - "Grave Clothes"
Josiah Russell & Mod G - "Make It" ⏳
Jubril - "Old House" ⏳
Kairo Music - "Expand My Kingdom" feat. Mark Pogue ⏳
Karissa Frampton - "Confident" ⏳
Karissa Frampton - "Valley" feat. Allyson Jenkins ⏳
Katy Nichole & Big Daddy Weave - "God Is In This Story"
Keith & Kristyn Getty & Michael W. Smith - "Christ Our Hope In Life And Death"
Ki Alexis - "23 (TWENTY 3)" ⏳
Kim Burrell - "Working For Your Good" ⏳
King Dareal - "WINNER (Freestyle)" ⏳
Kings Kaleidoscope - "Forever Again"
Kollektivet - "Urolige Hjerter" ⏳
Krissy Nordhoff & The Halls - "Out of the Woods"
Lazarus! - "Aye Bae Bae"
Lenise Antunes & Paula Schneider - "Amor É Só Isso" ⏳
Leslie Jordan - "Great I Am" ⏳
Lindy Cofer, Elyssa Smith & Circuit Rider Music - "Jesus The Healer (Live)"
Liv Douglas - "Tired" ⏳
Lj the Messenger - "HIGHER" ⏳
Local Sound - "Forevermore" ⏳
Manda - "Fantoche" feat. Rael
Mark & Sarah Tillman - "Greater is the Blood" ⏳
Matthew West - "Before You Ask Her"
Montell Fish - "Hollow Lover"
More Rain - "We Give You Praise" ⏳
Muntjac - "Year of the Drought" ⏳
MvkeyyJ & Mike Teezy - "Play You" ⏳
Natan El Profeta & Angelina Paulino - "Códigos" ⏳
Os Bravos - "O Senhor é Bom" ⏳
PEABOD - "MAD!"
Perdonado & Ross - "Pródigo" ⏳
Perry LaHaie - "Pure In Heart" ⏳
Porsha Love - "Helga" ⏳
RAY G - "LIGHTS OUT" feat. muted mike
Reblah - "Rise Up" ⏳
Rock City Worship - "How Could I Not"
Rock City Worship - "No Boundaries"
Russ Mohr - "More of Thee"
Saint Asonia - "Better Late Than Never"
Sansone - "Cold"
Sean BE - "Step Into My Story" ⏳
Shaylee Simeone - "Justified" ⏳
Simon Becker - "Freihändig" ⏳
StereoSnap - "Wait" ⏳
Switchfoot - "youth of the young (b-side)"
Tenielle Neda - "Same Side"
Tera Mardis - "You Find Me"
Tom Mottershead - "Always Will" ⏳
Tom Read - "62 (Spoken)" feat. Praise Lubangu
Toyalove - "Give You My Last" feat. Aaron Cole ⏳
Tre'Gadd - "RIGGED WARFARE" ⏳
Tye Tribbett - "Get Up" ⏳
Vineyard Worship - "Awaken Us" feat. Bernie Ditima ⏳
Wilder Adkins - "Sun Song" ⏳
Woodlands Worship - "More Than a Feeling (Live)" ⏳
Youngheart - "Your Love"
Zeal Worship - "As High As I Can Hold It" ⏳
4n - "WHAT!"6/11Blessing Airhihen - "Fresh Fire" ⏳
SIV & Moflo Music - "Drifting" ⏳6/12Garret Johnston - "Holy Father Reign" ⏳
Megan Lynette - "Broken" ⏳
Tobe Nwigwe - "ROUND HERE (PART ONE)"6/13The Salvation Project - "Humbled"6/14Gabriel Guedes de Almeida - "Todos Os Meus Dias (Ao Vivo)"
Jeferson Pillar - "Tragédia" ⏳
Mary Ozaraga - "Maharlika" ⏳
The Sound - "Jesus In My Dad" ⏳6/15Edward Rivera - "Toma Tu Lugar (En Vivo)" feat. Raquel Vega ⏳
Poor Bishop Hooper - "Psalm 129"
Vision of Leo, Joe L Barnes & Edgar Sandoval Jr - "FOUGHT 4 LOVE"6/16Fight The Fade - "Lost It All"
GABE ISAAC & Ethan Dufault - "Cloud 9"
Icon For Hire - "Dismantled"
Jeremi Licata - "Dear Prodigal"
Meyta - "Remnant" feat. Laykne ⏳
S.O. - "NOW OR LATER"
Stevie Valentine - "Vibin" ⏳6/17Aklesso - "Left Hand Shawty" ⏳
Andrea Olson - "What a God You Are"
Andrew Feeney - "Vulnerable"
Anthony Montuori - "The One Before Me" ⏳
Astrophysik - "Losing Faith" ⏳
Atinúké - "Worthy" ⏳
Bastian Benoa - "Schrei mich an" ⏳
Before Flags - "Turn" feat. Adryelle, We Dream of Eden & Patrick Spatz
Ben Fuller - "Proud"
Ben Lawrence - "love in the summer" ⏳
BNDSRVNT - "We Thought We Were Dreaming" ⏳
breezy down - "pages"
Cade Thompson - "Arms of Jesus"
Caleb Gordon - "Man of Steel"
Canyon Hills Worship - "Glory Hallelujah"
Chozen Dee - "Average" feat. 1K Phew ⏳
Chris Howland & Drew Ava - "Joyful Melody"
Christ Church Manchester Music - "Jesus Called Me" feat. Jake Woodward
Concepts - "Fatherhood" feat. S.O. ⏳
CRFT - "Magic" feat. Rockstar Jt ⏳
CRYS, Angie Rose & Samuel ASH - "RDV"
Curt Vernon - "Simply Put" feat. Stephen McWhirter ⏳
Davis Flin - "Morning Coastline" ⏳
Dru Bex - "Reality Checks" ⏳
Ethan Nathaniel & Taylor Armstrong - "Meet With You"
Eris Ford & Evan and Eris - "Bad Energy" feat. V. Rose ⏳
Hannah Honey - "goandtell" ⏳
G.E.T. LEGACY - "Wait for You" feat. Chavonne Stewart, Aaron Sledge & Nisan Stewart
jaylen. & ohsobrkn - "DOGS" ⏳
Jeremiah Broken - "My Purpose" ⏳
Jesse Wilson - "I Choose to Praise" ⏳
Jess Ray - "Born Again"
Joel Caws - "Faithful God"
John Michael Howell - "Hypothetically" ⏳
Juan Winans - "Tell That" feat. Mr. Talkbox ⏳
Justin Rizzo - "All Glory And Honor (Live)"
Kimberly Allen - "Glory" ⏳
Kip Wolfe & PRESTXN - "Best of Me"
K-SEE - "RENEGADE!" ⏳
Leah McFall - "At Your Feet"
Liv Douglas - "Wasted Time" ⏳
Manafest - "Here We Come" feat. OTTO BLUE
Maria Segerholm - "Chosen" ⏳
Marizu - "Hallow"
MAYTHÊ - "Eu Não Vou Morrer de Novo" ⏳
Nico Cabrera - "Te Necesito" ⏳
North Point Worship - "This Is My Song" feat. Mac Powell & Heath Balltzglier
Password - "Finally" ⏳
Reflect - "New Fredrick" ⏳
Ryan Hylton - "So Good"
SANCTUARY Worship - "Come To Jesus (Live)" feat. Blake Perry, Emoni Robinson & Kira Daffin ⏳
Saul City - "Silence" ⏳
Scootie Wop - "WASSUP!!!" ⏳
Shealy Worship - "This Is What We Came For (Live)" ⏳
Shepherd, George.Rose & Mike Teezy - "Night Owl" feat. EmanuelDaProphet ⏳
SONS THE BAND & Sam McCabe - "My Offering"
Streetlights & Prisims - "Masterpiece" ⏳
Sueño De Hormiga & A'san The Producer - "Me da Vueltas" ⏳
Swingin Hammers - "Primary Colors" ⏳
The Fosters - "God's Been Good" ⏳
Th3 Saga - "Store Run" ⏳
Tyler Murphy - "I Need You" ⏳
verboemcarne - "Guerra Interna" ⏳
Victoria Victoria & Charlie Hunter - "Over My Shoulder"
Vocal Livre, Paula Schneider & Bruno Santos - "Sonhar Pequeno" feat. Guilherme Ludtke ⏳
Wyn Starks, The Fisk Jubilee Singers & Built By Titan - "Sparrow" ⏳
Xay Hill - "No Tears" ⏳
YUILA - "Kommst du mit?" ⏳
7 Hills Worship - "Trust You (Live)"6/19Convergência Music - "Santo Amigo" feat. Inaiá Siqueira ⏳
Daryl Jay Kyle - "92" ⏳6/20Brylie Jaye Parker - "Freedom" ⏳
Tobe Nwigwe - "BIG SMALL BUSINESS" ⏳6/21Gloire Grace - "Juste toi et moi" ⏳6/22Lev - "Tot we thuis zijn"
MVMNT Music - "Best Medicine"
Poor Bishop Hooper - "Psalm 130"6/23Figueira - "Puro" ⏳
George.Rose - "Alive" feat. 1K Phew ⏳
NEEDTOBREATHE - "Talk of the Town"6/24Aaron Cole - "Choose You" ⏳
Abbie Allard - "The Life I Bring" feat. Jonathan Ogden ⏳
Ada Ehi - "I Will Sing (Refreshed)" ⏳
Alphein - "Lie To You"
Alvin Cedric - "Control"
Ashley D'aguiar - "He Who Began a Good Work" ⏳
Audrey Marie - "Sunflower Field" ⏳
Austin Joyce - "Pressure"
Ayiesha Woods - "God Forever" ⏳
Baylor Wilson - "Pharisee" ⏳
breezy down - "twirl"
Bre Harris - "Better" ⏳
Caleb Gordon - "Liberation" ⏳
Caleb McCoy - "Joy!" ⏳
Cecily - "Never Known A Love" feat. Meredith Andrews ⏳
Change The Kids - "KICKIN IT" feat. Apex Frazier ⏳
Colorvault - "So Sure" feat. Young Oceans & Alex Taylor
Crafted Child - "Gotta Believe" ⏳
Danielle Savard - "Sacred Space" ⏳
DEON - "Julius Caesar" feat. 1K Phew & 1K Pson ⏳
Drup - "Peace" feat. Casper Sage & Parris Chariz ⏳
Dwayne Tryumf - "El Shaddai"
Ethan Nathaniel & Taylor Armstrong - "Picking Me Up" ⏳
Fearless BND - "Holy Ghost" ⏳
Gil Joe - "Made Whole" ⏳
Grace Union - "Mercy" ⏳
iAmSon - "I Wanna Know" feat. Lisa Oduor-Noah
Jay-Way & Digitzz - "DEEP END" ⏳
Jeremiah Bonds & Shane Newville - "Stop Defending Me" ⏳
Jesus Image - "Come Lord Jesus (Live)" feat. Jeremy Riddle
Jonas Myrin - "Mountains"
Jonathan Allen Wright - "You Still Believe In Me" ⏳
KAYDEN - "HATE TO TRY"
Kenneth Townsell - "The One" ⏳
KXC, Rich & Lydia Dicas & Damilola Makinde - "Pull Me Through (Live Single Version)" ⏳
Lazarus! - "LOOK AT HIM!"
Limoblaze, David Okit & Oneskript - "Never Seen" ⏳
Liv Douglas - "Proud of Me" ⏳
Lizzy Parra & Angel Brown - "Vuelo" ⏳
Marie Love & Saint James - "Need You"
Mas - "limbo" ⏳
Matt Maher - "The Lord's Prayer (It's Yours)"
Micah Tyler - "I See Grace"
Naomi Raine - "World On Fire" feat. Ryan Avery
Natalie Layne - "Love Me Back to Life"
Natural State - "Lead Me" ⏳
Nu Tone - "Wicked Ways" feat. Gabby Callwood ⏳
On Earth, Michael Gungor & Tyler Chester - "Unseen Hand"
Paul Rarity & A Mose - "The Best" ⏳
Paul the Messenger - "Bounty" ⏳
Purples - "meu lugar"
RAY G - "EVRYTHNG BUSSIN" feat. 1K Phew & muted mike ⏳
Reconcile, Og Bobby Billions & D Brooks the President - "Father Forgive Us" ⏳
Red Tips - "Nino Brown" ⏳
Reed Deming - "friends" ⏳
Ri-An & MDSN - "OK With That"
Ryan Ellis - "New Wine Flow"
Sho Baraka - "Where Do We Go?" ⏳
SHORE - "i tried" ⏳
SiahThyLegend - "Manga" feat. J J L & Lil Yelli ⏳
Steph Andrews - "Someone Else" ⏳
Stryper - "Rise to the Call"
tamsin frost - "Little by Little" ⏳
Tedashii, Trip Lee & Lecrae - "Respect My Team"
TEMITOPE - "THAT'S WHAT I BELIEVE" ⏳
The GLO. Collective - "No Popstar" feat. CJ Emulous, KidViz, Miles Minnick & NK4
TKE3 - "Falling" feat. Marizu ⏳
Wes Harris & Sarah Nathalié - "bounce back."
White Ribbon Day - "Salt Air"
Woodlands Worship - "Everything I Need (Live)" ⏳
Zayah. - "You Provide, Pt. 1" feat. Caleb LaDuke
Zoe Jean Fowler - "Run" ⏳
100graham - "Graduate"
29:11 Worship - "May It Be Jesus"
5ive - "Die Daily" feat. Co Campbell ⏳6/25IC Worship - "Wohoo (Jesus Is Alive)" ⏳6/26Tobe Nwigwe - "ROUND HERE (PART TWO)" feat. Fat Nwigwe6/27Debora Spagnolo - "Vittoria"6/28Cintia Alves - "Me Ajude a Crer"
Jotta A - "Apollo 11"
S.O. - "Epic" ⏳6/29Poor Bishop Hooper - "Psalm 131"6/30Dirk - "We've All Been There Before" ⏳
LÉA-SOPHIE - "Befreit!" ⏳
Madiel Lara - "Party"
Natan El Profeta, Ariel Worship & Matty Martinez - "Me Sedujiste" ⏳
RandyB Funk - "Footwork" ⏳
Symparthegod - "graduation freestyle" ⏳