AJR - "God is Really Real"
Lauren Alaina - "Just Wanna Know That You Love Me"
Peter Gabriel - "So Much (Dark-Side Mix)"
Priya Ragu - "Easy"
Soulja Boy - "Stick To The Plan"
7/5
Anne-Marie - "TRAINWRECK"
ANOHNI and the Johnsons - "Why Am I Alive Now?"
Bag Raiders - "Love Me Back"
IShowSpeed - "Portuginies"
7/6
Declan McKenna - "Sympathy"
kkbutterfly27xx - "Barbie Lifestyle (From Barbie The Album)"
Likkle Vybz & Vybz Kartel - "Lemonade"
Nicky Jam, The Chainsmokers & Maluma - "Celular"
Nippa - "Reverse"
Russ Millions - "One Man"
Tori Brixx - "BIG OL" ft. Rich The Kid

7/7
AK - "Lowkey"
Babyface Ray - "Donda Bag"
Bebe Rexha, Snoop Dogg & Alle Farben - "Satellite (Alle Farben Remix)"
Becky Hill, Lewis Thompson & Shouse - "Side Effects (Shouse Remix)"
Cadenza, BEAM & Amaarae - "Amp It Up"
Chelsea Collin - "ANGEL"
CHIKA - "DEMIGOD"
Cyndi Lauper - "Oh, Dolores"
Daughtry - "Separate Ways (Worlds Apart) (Stripped Down)" ft. Lzzy Hale
DDG - "Trynna Link"
DeathbyRomy - "Even If It Bleeds"
​easy life - "palmtreedays_1644.wav"
FendiDa Rappa & Cardi B - "Point Me 2"
FIFTY FIFTY - "Barbie Dreams" ft. Kaliii
FRVRFRIDAY - "SUMMER'S UP"
gavn! - "​​​​​​how are you now"
Hayden James & Bob Moses - "Do You Want Me"
Jax Jones & Fireboy DML - "Me and My Guitar"
Jon Vinyl & Jeremy Passion - "Thinkin Bout You"
Katelyn Tarver - "Cinematic"
Kendra Jae - "Count Your Blessings"
Kiiara - "Cum in Peace"
KILLY - "Same Energy"
kkbutterfly27xx - "Barbie Lifestyle (From Barbie The Album)"
Kylie Minogue - "Padam Padam (ABSOLUTE. Padam All Weekend Remix Edit)"
Kurt Hugo Schneider & Andie Case - "Ain't No Sunshine"
LANY - "Alonica"
LAYA - "F'd Up"
Lil Skies - "How Things Go"
Lil Tjay - "Project Walls" ft. YoungBoy Never Broke Again
Lupe Fiasco - "CHANNEL No3"
Meduza - "Phone" ft. Sam Tompkins & Em Beihold
Melvoni - "WANNABE"
Mick Jenkins - "Smoke Break-Dance" ft. JID
midwxst - "pretty girls"
Natalie Jane & charlieonnafriday - "I'm Good"
Nathan Dawe, Joel Corry & Ella Henderson - "0800 HEAVEN (Acoustic)"
NewJeans - "New Jeans" ft. The Powerpuff Girls
PARTYNEXTDOOR - "R e s e n t m e n t"
Purple Disco Machine & Kungs - "Substitution (KUNGS Live Edit)"
Rico Beats - "Real Spill" ft. G Herbo
Sam Smith, Jessie Reyez & Cat Burns - "Perfect"
Scarlxrd - "Feel Wxrthless?"
Sixto Rein - "Texteando" ft. Carmen DeLeon
Skrillex & Boys Noize - "Fine Day Anthem"
tana - "KNOYA"
Tech N9ne - "W H A T (We're Hungry And Thirsty)" ft. kim dracula & HU$H
The Ready Set - "Teammate"
Tom Grennan - "How Does It Feel (Acoustic)"
TOMORROW X TOGETHER & Jonas Brothers - "Do It Like That"
Tove Lo & Dorian Electra - "I like u (Dorian Electra Remix)"
Tyla Yaweh - "SUMMER VIBES"
Valee, Harry Fraud & Action Bronson - "Vibrant"
Windwaker - "SIRENS"
Zara Larsson - "End Of Time (SPINALL Remix)"
7/10
​poptropicaslutz! - "What Would You Do To Get Ahead(line)?"
7/11
Kevin Leonardo - "Nair Apology (Toxic Gossip Train)"
Mozzy - "Count Time"
YTB Fatt & Big Homiie G - "Us"
7/12
Belhassen Kadim - "Like That (Jada)"
FCG Heem - "Crime Pays"
Reneé Rapp - "TALK TOO MUCH"
Sleepy Hallow - "Good Girls Ain't No Fun"
7/13
Anuel AA & Quavo - "Baby" ft. DJ Luian & Mambo Kingz
Billie Eilish - "What Was I Made For?"
Blac Youngsta - "Free Thugger"
DCG Brothers - "Back Out" ft. Mello Buckzz
Duki, KHEA & Bizarrap - "Remember Me"
KAROL G - "S91"
Pink Sweat$ - "Guitar"
Royal Blood - "Pull Me Through"
Troye Sivan - "Rush"
7/14
3LAU - "Happy/Sad"
Alan Walker & Zak Abel - "Endless Summer"
Anne-Marie - "UNHEALTHY (VYLAN Remix)"
Becky Hill & Chase & Status - "Disconnect"
Benny Benassi & Emma Muscat - "M.I.A"
Byron Messia - "Talibans (Spaceship Billy Amapiano Mix)"
BIA - "Raised Me"
Caity Baser - "Leave Me Alone (Stripped)"
CHASE WRIGHT - "I Don't Think That I Could Love You"
Chelsea Cutler - "I Don't Feel Alive"
Coco Jones & Justin Timberlake - "ICU (Remix)"
Colbie Caillat - "Wide Open"
Cyn - "Where Do All The Diamonds Go?"
Demi Lovato - "Sorry Not Sorry (Rock Version)" ft. Slash
Duke Dumont - "Losing Control" ft. Nathan Nicholson
Emotional Oranges & ZHU - "Not Like This"
Farina & Sean Paul - "EL VIBE"
Finesse2Tymes - "Revelations"
Gabry Ponte & Don Diablo - "Sunglasses At Night"
Gucci Mane - "Woppenheimer"
Icewear Vezzo - "Raw ASL"
ILLENIUM, Avril Lavigne & Travis Barker - "Eyes Wide Shut (Sickick Remix)"
Imagine Dragons - "Believer (Live in Vegas)"
Jason Derulo - "Glad U Came (Acoustic Wedding Version)"
Jess Glynne - "What Do You Do?"
Joel Corry, Icona Pop & Rain Radio - "Desire"
JT - "No Bars"
Jung Kook (정국) - "Seven (Clean Ver.)" ft. Latto
Jung Kook (정국) - "Seven (Explicit Ver.)" ft. Latto
Krúbi - "Krúbi Interjú"
Lil Gnar - "PB&J" ft. Chief Keef & Young Nudy
Lucas Estrada, Jay Mason & Edwardo Atlas - "Hills in LA"
Matoma & Sadie Rose Van - "Don't Give Up on Me"
Mickey Guyton - "Nothing Compares to You" ft. Kane Brown
Nathan Dawe, Joel Corry & Ella Henderson - "0800 HEAVEN (Ben Nicky Remix)"
Olivia O'Brien - "​​​​​​i should've fucked your brother"
PGS Spence - "Buckle Up"
PinkPantheress & Destroy Lonely - "Turn Your Phone Off"
Post Malone - "Overdrive"
Quavo & Future - "Turn Yo Clic Up"
Riton & Belters Only - "Never Knew Love"
Robert Glasper - "Back To Love" ft. SiR & Alex Isley
Robin Schulz - "Smash My Heart"
SAHXL - "Redo @ Luv"
Sett - "Call My Bluff"
SKYLAR - "Crocodile Tears" ft. piri
Spencer Sutherland & Meghan Trainor - "Chicken Little"
Surf - "Alfa Romeo"
The ATG - "Back to back" ft. Icewear Vezzo & Ko'il
Thirty Seconds to Mars - "Get Up Kid"
Tim McGraw - "Standing Room Only (Acoustic)"
Tray Haggerty & Fredo Bang - "Undivided Attention"
Vybz Kartel & Popcaan - "Dull Colour"
WARGASM - "Do It So Good"
Zara Larsson - "End Of Time (Kungs Remix)"
ZEDNED - "smile"
7/15
Jeremih - "Room" ft. Adekunle Gold & 2 Chainz

7/17
Budjerah - "Video Game"
Leslie Shaw - "Dile Adiós a Tu Ex"
Peter Gabriel - "So Much (Bright-Side Mix)"
That Mexican OT & Left Sm - "Barrio"
ZEDNED - "waiting for you"
7/18
beabadoobee - "the way things go"
‎kurtains - "skin"
Slowdive - "skin in the game"
Valiant - "Mad Out"
YTB Fatt & Rob49 - "Bet I Whip It"
7/19
eydrey - "El Gato"
J. Cole & Bas - "Passport Bros"
Lil Dann - "Family Freestyle" ft. Lil Baby
Mr Eazi - "Chop Time, No Friend"
OMB Peezy - "Never Change" ft. Peezy
Poppy - "Knockoff"
Stormzy & RAYE - "The Weekend"
The Mountain Goats - "Clean Slate"
7/20
A$AP Rocky - "RIOT (Rowdy Pipe'n)"
BigWalkDog - "On They Neck"
Blake Rose - "How Do We Stay In Love?"
DJ Maff & ELENA ROSE - "Limonadita Fresca"
Kaliii - "K Toven"
NEEDTOBREATHE - "The Cave"
NSG - "Ride" ft. Nines
Ryan Trey - "SPELMAN MUSIC (FREESTYLE)"
7/21
6ix9ine & Yailin la Más Viral - "Shaka Laka" ft. Kodak Black
Aidan Bissett - "Sick"
AK - "Mirror"
Alesso & John Newman - "Call Your Name"
Amaal - "The Middle"
Anselmo Ralph - "Sola" ft. Rick Ross & Soge Culebra
Becca Means - "My Darling"
Benicio Bryant & Audrey Mika - "Move to Mars"
Burna Boy & Byron Messia - "Talibans II"
Cassadee Pope - "Almost There"
Cate - "U Want Me"
CG5 - "THX"
​charlieonnafriday - "I'm Not Crazy"
Chris Stapleton - "White Horse"
Chris Young - "Young Love & Saturday Nights"
Dax - "God's Eyes"
Dimitri Vegas & Like Mike, David Guetta & Afro Bros - "She Knows"
Dimitri y las brujas - "He Cambiado" ft. Nicole Favre
Diplo, Jessie Murph & Polo G - "Heartbroken"
Fly By Midnight - "Infinitely Falling (Romantic Redraw)"
FRENSHIP, OSTON & kate the dreamer - "Sad Anymore"
Fridayy - "When It Comes To You"
Grace VanderWaal - "Boyfriends"
Gucci Mane - "Married with Millions"
Hozier - "De Selby (Part 2)"
Idina Menzel - "BEAST"
ILLENIUM & Avril Lavigne - "Eyes Wide Shut (Culture Code Remix)" ft. Travis Barker
Jax Jones & Fireboy DML - "Me and My Guitar (Midnight Snacks Remix)"
Jay Rock & Anderson .Paak - "Too Fast (Pull Over)" ft. Latto
Kate Stewart - "Never Enough"
Ken Carson - "its over"
kkbutterfly27xx - "PARTY ALL NIGHT"
Lancey Foux - "MMM HMM" ft. Sexyy Red
Leigh-Anne - "Don't Say Love (Mas Tiempo Remix)"
LG Malique - "Winning"
Lil Blessin, Travis Scott & G Herbo - "Likka Sto" ft. BIA
Lil Tecca - "500lbs"
Lupe Fiasco - "Roc-A-Fella Y'all"
Malik Baptiste - "WHO?!"
Mario & Lil Wayne - "Main One" ft. Tyga
Noname - "Balloons" ft. Jay Electronica & Eryn Allen Kane
Oliver Tree - "One & Only"
OnSight Deeda - "I'm Wit It"
RAAHiiM - "Famous (Lost to LA)"
Real Boston Richey - "Send a Blitz"
Russell Dickerson - "Beauty and the Beach (Remix)" ft. Flo Rida
Sam Smith - "Man I Am"
Sara Kays - "Show Me Off"
Scooter & Timmy Trumpet - "For Those About To Rave"
Sett & Tay Keith - "Teamo"
SleazyWorld Go - "Don't Get Ya Feelings In It" ft. Luh Tyler
Snoh Aalegra - "Be My Summer"
Tinashe - "Talk To Me Nice"
Tom Grennan - "How Does It Feel (Boris Way Remix)"
Tones and I, BIA & Diarra Sylla - "BRING IT ON"
Tony K - "Island"
Travis Scott, Bad Bunny & The Weeknd - "K-POP"
will.i.am & Britney Spears - "MIND YOUR BUSINESS"
Will Manning - "Don't"
Zach Hood - "​​​​​​neon skies"
ZAYN - "Love Like This"
7/23
kwite - "a Look in"
7/24
Brother Marshall & The Choir of Fire - "All The Gold In California"
NateWantsToBattle - "To Let Go"
7/25
Big One, Ulises Bueno & Rusherking - "Mentiras CROSSOVER #3"
Trueno & Cypress Hill - "F**K EL POLICE (REMIX)"
YTB Fatt - "Backstabbin"
7/26
Alaina Castillo - "hookah envenena"
Eladio Carrión - "6PM En Mallorca"
Laufey - "Bewitched"
Mac Critter - "Soap"
Mitski - "Bug Like an Angel"
Sesentay6 & Delgao - "Con Tu Mala"
7/27
BiC Fizzle - "All The Way Up"
Dan García - "Tirando Flow Sesh #11" ft. Dani Flow, El Bogueto, Ritorukai & Uzielito Mix
Denzel Curry - "BLOOD ON MY NIKEZ" ft. Juicy J
Dylan Gosset - "Coal"
EMJAY & FLVCKKA - "SAD BITCH"
James Marriott - "Romanticise This"
Jessie Ware & Róisín Murphy - "Freak Me Now"
Juliana - "Cuando Te Encuentre"
Kill Jasper - "Go"
Papi Sousa & Álvaro Díaz - "POKE FREESTYLE"
loopcinema - "MÁGIKA!"
piri & Tommy Villiers - "lovergirl"
Ramon Vega - "dEsANiMaO" ft. Christian Nodal
Sofía Reyes & Danna Paola - "​​​​​​tqum (Remix)" ft. Kim Petras

7/28
916frosty, Coults & Zubin - "Drunk As Hell"
Ashnikko - "Cheerleader"
Billen Ted & Kah-Lo – "Feel The Burn"
Blessd & Maluma - "EL RELOJ"
BOYS LIKE GIRLS - "THE OUTSIDE"
Burna Boy - "Big 7"
Calboy - "On My Own"
Calvin Harris & Sam Smith - "Desire"
Busted & Jonas Brothers - "Year 3000 2.0"
Chanel & Ptazeta - "Ping Pong"
David Guetta & MORTEN - "Something To Hold Onto"
Glades – "Goodbyes" ft. FRENSHIP
Grimes & Illangelo - "I Wanna Be Software"
Jack & Jack - "What Happened"
Jay Wheeler, Dei V & Hades66 - "Pacto (Remix)" ft. Luar La L, Anuel AA & Bryant Myers
Loser - "✧ crystal mommy ✧" ft. David Shawty
Lucas Estrada & Adam Woods - "Moonlight"
Kris Allen - "I'm a Believer"
Layton Greene - "Twerk Like Lizzo" ft. Erica Banks & Moone Walker
LG Malique - "On Time" ft. Toosii & Kiya Alexius
Leon Thomas - "Breaking Point (Remix)" ft. Victoria Monét
Lucas Estrada & Adam Woods - "Moonlight"
Matchbox Twenty - "Push (Sped Up Version)"
Mike Williams & The Him - "Down The River" ft. Travie's Nightmare
Offset & Cardi B - "JEALOUSY"
Saweetie - "BIRTHDAY" ft. YG & Tyga
S Club - "These Are The Days"
Shania Twain - "You're Still The One (Frank Walker Remix)"
Smash Mouth - "Underground Sun"
SpotEmGottem - "Dummie"
Switch Disco - "REACT (Sam Feldt Remix)" ft. Ella Henderson
The Chainsmokers & Shenseea - "My Bad"
TOMORROW X TOGETHER & Jonas Brothers - "Do It Like That (Pop R&B Remix)"
Walker Hayes - "Show Me the Country"
Walker Hayes - "Stetson"
YXNG K.A - "Through the Storm"
7/31
Apel8 - "Heat" ft. Dro Kenji