Roaring 20s - Flo Milli
Girls Like Us - Zoe Wees
Masterpiece - DaBaby
De Una Vez - Selena Gomez
Connexion - ZAYN
34+35 Remix (feat. Doja Cat, Megan Thee Stallion) - Remix - Ariana Grande
Deal With It (feat. Kelis) - Ashnikko
Kingsten - Ballin
Grey - Why Don't We
Close To You - Dayglow
Line By Line - JP Saxe
this is how you fall in love - Jeremy Zucker
Chemtrails Over The Country Club - Lana Del Rey
He Said (feat. Miguel) - dvsn
Lie Lie Lie - Joshua Bassett
Goosebumps - Remix - Travis Scott
Your Love (9PM) - ATB
Never Gonna Forget (with Diplo feat. Elderbrook) - Black Coffee
Guard Up - Pooh Shiesty
OOPS - Spotify Singles - Gabriel Garzón-Montano
Bonafide (feat. Chiiild) - Emotional Oranges
ANTES QUE SALGA EL SOL - Natti Natasha
Don't Play - Anne-Marie
Excuses - Audrey Mika
Upgrade - Jessie Murph
Comeback. - Gallant
Split - Rich The Kid
Lonely - Sofía Valdés
MY HEAD :( )- Jack Kays
Waiting On A War - Foo Fighters
raw - LOONY
Trippin - Kara Marni
Easy - Pale Waves
Part of Me - Healy
Calls - Charlie Houston
WOMAN - Avenue Beat
Blame Game - Beach Bunny
ultraviolet.tragedies (with Terrell Hines) - X Ambassadors
long txts - Lubalin
WEGO - KBFR
Game Time - Funkmaster Flex
Is You Fuckin? - Yella Beezy
Doin My Dance (feat. Moneybagg Yo) - Fredo Bang
Messed Up - Asiahn
Villain - Wolf
Weekend Vibe - Jubël
The World We Left Behind (feat. KARRA) - KSHMR
Duke and the Cash - Baby Boys
Hate Myself - dodie
pink party - Isaac Dunbar
What You Need (feat THEY.) - Jae Stephens
Calla Tú - Danna Paola
How We Used To - Stephanie Poetri
IDFIATOK - Ameer Vann
Bandemic - Bizzy Banks
Twisted Tongues - AFI
hold somebody - guccihighwaters
Queen - G Flip
Hollow - Mills
Undivided - Tim McGraw
Sanctuary - Hiss Golden Messenger
Cuff Your Jeans - Claud
Your Life Your Time - Christian Leave
Listen!!! - Aly & AJ
Lose You Now - Lindsey Stirling
drinkup - pink roses
Walk Away - Duke & Jones
Edge Of The Dark - Emmit Fenn
Things Changed - The Sunshine State
Beautiful - Robin Thicke
HWAA - (G)I-DLE
NonChalant - Metro Marrs
In The Kitchen - Pote Baby
Hit This - Ebhoni
I Know I Been Changed (Music From The Motion Picture "American Skin") [feat. Gary Clark Jr.] - Keedron Bryant
wish you the best (feat. Jensen McRae) - Joy Oladokun
All That Lasts - Pablo Dylan
Minimum Wage - Blake Shelton
Breakups - Seaforth
Whatever Forever Is - Devin Dawson
Oidar - Hether
Dancing Alone - Kings Elliot
Raw Thoughts - Baby Queen
Skengman (feat. Stormzy) - Ghetts
Toothpaste - Wacotron
ULTIMA - Body Meat
STRENGTH BONUS - blackwinterwells
Fuck Being Sober - Annika Wells
Access - Major Murphy
The One That Got Away - Hunter Hayes
Unstoppable (Do It Again) - Angie Rose
Rose - Fruit Bats
alien jewelry - John The Blind
USMO - John-Robert
Still Not Dead - DREAMERS
Glasgow - You Me At Six
State of Wonder - inverness
dramatic - Cat & Calmell
We Need You - Titus Showers
I Will Overcome - Welshly Arms