Feid - VENTE CONMIGO
Bebe Rexha - One in a Million
Lil Yachty - Slide
Post Malone - Joy
Cordae - Make Up Your Mind
Swedish House Mafia - Ray Of Solar
Usher, 21 Savage & Summer Walker - Good Good
Halle - Angel
Kali Uchis, El Alfa & JT - Mu√±ekita
Yo Gotti - The One
Dan + Shay - Always Gonna Be
Lauv - Love U Like That
Jorja Smith - GO GO GO
Trippie Redd - Left 4 Dead
Grupo Frontera & Grupo Firme - EL AMOR DE SU VIDA
Stephen Sanchez - Be More
Mae Stephens & Meghan Trainor - Mr Right
Brett Young - Love Go–µs On
Jordan Ward & 6LACK - MUSTARD
MAX - STRINGS (feat. JVKE & Bazzi)
XG - TGIF
Wiz Khalifa - Hype Me Up
Eliza Ros–µ & The Martinez Brothers - Pleasure Peak
Cian Ducrot - Endless Nights
Bennett Coast - Now I Know You
Brenn! - Valapriso
Charles Wesley Godwin - All Again
Uncle Waffles & Tony Duardo - Echoes (feat. Manana & Lusanda)
Lauren Daigle - Be Okay
Darius Rucker - Have A Good Time
James Arthur - Blindside
LANY - XXL
Cannons - Desire
NATTI NATASHA - NO PARE
ITZY - CAKE
Denzel Curry - ICE COLD ZEL FREESTYLE (feat. ICECOLDBISHOP)
Yung Gravy - Nightmare on Peachtree Street (feat. Freddie Dredd)
Tyla Yaweh - City Of Dreams (feat. Chris Brown)
Poolside - Float Away
The Maine - dose no. 2
BoyWithUke - Trauma
Yung Bleu - Confirmation
DESTIN CONRAD - OUTTA CONTROL
Œ£tella - Girl Supreme
Ari Abdul - Make Me Cry (feat. Deadbeat Girl)
The Front Bottoms - Not Joking
Tones And I - The Greatest
Ciara & Chris Brown - How We Roll
Sauce Walka - ONLY FANSüïí
Ez Mil & Eminem - Realest
Giggs & Diddy - Mandem
Felix Cartal & Karen Harding - Need Your Love
Bathe Alone - Blue Days
Julia Pratt - A Little Love
Chri$tian Gate$ - Take Me Back
Mammoth WVH - I'm Alright
Dylan & Bastille - Liar Liar
audalei - how's it feel to be a boy
Snoh Aalegra - Sweet Tea
Micha√´l Brun & Joeboy - Game Over
Jai Wolf - Don't Look Down (feat. BANKS)
Robin Schulz - Atlantis (Robin Schulz Presents KOPPY)
Junior H & Grupo Firme - El Patrocinador
Kylie Morgan - A Few Hearts Ago
Savana Santos - cheater
Towa Bird - This Isn't Me
Brandon Lake - Count 'Em
‚úù‚úù‚úù (Crosses) - Invisible Hand
Rob49, Skilla Baby & Tay B - Mama
Kalan.FrFr - BUTTERFLY COUPE feat. Tyga
Karan Aujla & Ikky - Admirin' You (feat. Preston Pablo)
marinelli - Irish Goodbye
Orla Gartland - Kiss Ur Face Forever
SebastiAn - TWIN
Kevin Ross - Ready For It (feat. Eric Bellinger)
BAMBII - Hookedüïí
Durand Bernarr - Kiss from a Rose
No Guidnce - Let It Rain
Gera MX - Feria en el Sobre
REASON - The Soul Pt. 3
Rexx Life Raj - Cleanse
Keyon Harrold - Don‚Äôt Lie (Feat. Malaya)
Avery Anna - Worst In Me
Priscilla Block - Fake Names
The Story So Far - Big Blind
Nia Archives - Bad Gyalz
The Linda Lindas - Resolution/Revolution
Ethan Bortnick - Doppelg√§nger
BLP KOSHER - The Nac 3
DC The Don - Tell Shyanne
B-Lovee & Luh Tyler - Gang Gang
Nao - Balance (feat. Skillibeng)
Chesca & Mariah Angeliq
Alina Baraz - Keep Me In Love
Kirnbauer - Mucho Peor - Spotify Singles
Morgan Wade - Fall In Love With Me
King Calaway - Let It Flow (feat. Hailey Whitters)
DPR IAN - Peanut Butter & Tears
Winona Fighter - Johnny's Dead