Zedd & Liam Payne - Get Low
21 Savage - Bank Account
French Montana - Bring Dem Things feat. Pharrell Williams
Cash Cash - All My Love feat. Conor Maynard
Marc E. Bassy - Plot Twist feat. KYLE
HAIM - Kept Me Crying
The All-American Rejects - Sweat
Sabrina Carpenter - Why
Lewis Capaldi - Lost On You
AlunaGeorge - Turn Up The Love
Sevyn Streeter - Anything U Want feat. Wiz Khalifa, Jeremih & Ty Dolla $ign
Urban Cone - Pumping Up Clouds
Wolf Alice - Don’t Delete The Kisses
Moh Flow - Options feat. Pusha T
Cousin Stizz - Lambo
Coldplay - A L I E N S
Dagny - Wearing Nothing (Cheat Codes X CADE Remix)
Tyga - Move to L.A. feat. Ty Dolla $ign
CAZZETTE - Run The World feat. Nadia Gattas
LÉON - Surround Me
Capital Cities - Swimming Pool Summer
Broken Social Scene - Protest Song
The XCERTS - Feels Like Falling in Love
Jillian Jacqueline - Reasons (Acoustic)
Old Dominion - Written in the Sand
Rhye - Summer Days
Sweater Beats - Glory Days feat. Hayley Kiyoko
Leikeli47 - Miss Me
Dae Dae - New Wave
A$AP Twelvyy - Strapped
Steve Aoki & Yellow Claw - Lit feat. Gucci Mane & T-Pain
J HUS - Did You See (French Montana Remix)
DVBBS & CMC$ - Parallel Lines  feat. Happy Sometimes
MisterWives - Ride (Recorded at Spotify Studios NYC)
Joywave - Going to a Place
Lucy Rose - Second Chance
KOLAJ - First Time With You
Joey Bada$$ - Love Is Only a Feeling
Reo Cragun - Night Crawler
Jez Dior - Sober
Meek Mill - Backboard feat. Young Thug
Dylan Hyde - Clearly
Quinn XCII - Fake Denim
Toulouse - Reach Out
Methal - Cycles feat. X Ambassadors
TYSM - Wraith
Opia - Faded
Manila Killa & Robotaki - I Want You feat. Matthew John Kurz
Toro y Moi - Mona Lisa
R I T U A L - Better By Now
HONNE - Just Dance
Mura Masa - Nuggets feat. Bonzai
Jennifer Lopez - Ni Tú Ni Yo feat. Gente De Zona
KONO - House of Glass feat. Havana Brown
MJ Cole - Shelter feat. Bruno Major
Jade Bird - Something American
Elliot Root - Wicked Lies
Black Magic & Fetty Wap - Wonder
EMBRZ - Fire feat. pennybirdrabbit