Calvin Harris - Miracle (with Ellie Goulding)
d4vd - Worthless
Maluma - La Reina
TWICE - SET ME FREE (ENG)
Blxst - Passionate (feat. Roddy Ricch)
NLE Choppa - MO UP FRONT
Miley Cyrus - Jaded
Meghan Trainor - Mother
NF - MOTTO
6LACK - Talkback
Tame Impala - Wings Of Time
Christine and the Queens - To be honest
Lauren Daigle - Thank God I Do
Tim McGraw - Standing Room Only
PNAU - The Hard Way
Rae Sremmurd - Tanisha (Pump That)
The Blaze - MADLY
Ti√´sto - All Nighter
Myke Towers - AGUARDIENTE
Miley Cyrus - Thousand Miles (feat. Brandi Carlile)
Carrie Underwood - Out Of That Truck
Sam Hunt - Outskirts
VALORANT & ericdoa - ‚Äã‚ÄãÀÉone
Eladio Carrion - Mbappe - Remix
Godfather of Harlem - Street Opera (Swizz Beatz feat. SAINt JHN, Fivio Foreign & BIA)
Musiq Soulchild - white rice d√©j√† vu
Meet Me @ The Altar - T.M.I
JELEEL! - GNARLY! (WITH ARMANI WHITE)
Lola Brooke - So DISRESPECTFUL
Becky G - Arranca (feat. Omega)
Cartel De Santa - Shorty Party
Cuco - Si Me Voy (with The Mar√≠as)
Stephen Dawes - Lose My Mind
Megan Moroney - Lucky
Zeph - like everyone else
Chelsea Cutler - Stay Anything
Elmiene - Choose You
Benny Sings - Pyjamas (feat. Remi Wolf)
Indigo De Souza - Smog
WHIPPED CREAM - Rewind.. (But I Love You)
G Perico - Mind Body Soul
ArrDee - Home For My Heart
Ovy On The Drums - EL HECHIZO
Pardyalone - Alone (feat. Travis Barker)
Devon Cole - Call U After Rehab
GAYLE - everybody hates me
aldn - headstrong gunner
R3HAB - Run Till Dark (with Now United)
Bryce Vine - Nostalgia
The War and Treaty - Have You A Heart
Reggie Becton - Life
Conway the Machine - Le Chop
Pouya - HEADCRACK
Rvssian - No Me Controles
Claire Rosinkranz - Never Goes Away
Mae Muller - I Wrote A Song
Joel Corry - Nikes
Nia Archives - Sunrise Bang Ur Head Against Tha Wall
Chromeo - Words With You
SBTRKT - Waiting
Joyner Lucas - Devil's Work 2
Saint Levant - From Gaza, With Love
Nicki Nicole - NO voy a llorar
Torren Foot - New Bottega
Rezz - Suffer In Silence
Seeb - Submarine
Quando Rondo - Tear It Down
Lil Keed - Self Employed
Venna - Tam Tam
The South Hill Experiment - Gabo's Last Resort
Sebastian Mikael - It's You
Manchester Orchestra - The Way
Forrest Frank - LIFT MY HANDS
gigi - Sally
Bartees Strange - Daily News
Parker McCollum - Speed
Khamari - On My Way
MARIS - Crashland
dee holt - dishes
Angel Olsen - Nothing's Free
Terrace Martin - Insane (feat. Ant Clemons)
Sam Austins - Keep You Companyüïí
Panchiko - Failed at Math(s)
Fever Ray - Even It Out
Mike Shinoda - In My Head
Bankrol Hayden - Penthouse (feat. Zzz.)
Zay Johnny - Poed Upüêö
Barrie - Empty
nicole han - NERVE
Alaska Reid - Back To This
Drew Holcomb & The Neighbors - Find Your People
Softee - Isn't Enough
TRACE - Stomachache
Boj - 2 Bad
Alice Longyu Gao - Come 2 Brazil
Tommy Lefroy - The Mess
iayze - I See (2 Many)
FNF Chop - Need All Mineüêö
KSHMR - Major Lazer