League of Legends & NewJeans - GODS
Tems - Me & U
JENNIE - You & Me - Coachella vers.
Lil Yachty & J. Cole - The Secret Recipe
Omar Apollo - Live For Me
Noah Kahan & Kacey Musgraves - She Calls Me Back
Old Dominion - Different About You
blink-182 - DANCE WITH ME
Kenya Grace - Only In My Mind
Dom Dolla - Saving Up
Fivio Foreign - Why Would I?
Sufjan Stevens - A Running Start
Earl Sweatshirt & The Alchemist - Vin Skully
Junior H - Y LLORO
Mac DeMarco & Ryan Paris - Simply Paradise
Kevin Abstract - Blanket
Nessa Barrett - club heaven
BoyWithUke - Problematic
Lovejoy - Normal People Things
Darius Rucker - Never Been Over
Cuco - Planet Express
Jessie Murph & Jelly Roll - Wild Ones
Majid Jordan - Hands Tied
NEIL FRANCES - Energy
JayO - Backüêö
Denzel Curry - WOO (Feat. PlayThatBoiZay, Chief Pound)
Joel Corry - Hey DJ
IVE - Off The Record
Sleater-Kinney - Hell
Aidan Bissett - How's It Gonna End?
Holly Humberstone - Kissing In Swimming Pools
Vedo - Luv To A Fck Song
James Arthur - Just Us
Colbie Caillat - Meant For Me
Eslabon Armado & Gabito Ballesteros - La Fresa
jxdn - Chrome Hearted
Ofenbach - Overdrive (feat. Norma Jean Martine)
Tee Grizzley - Grizzley 2Tymes (feat. Finesse2Tymes)
Kevin Gates - God Slippers
Pitbull - It Takes 3
Mike Shinoda - Already Over
Kirk Franklin - Again
Dylan Gossett - Beneath Oak Trees
Surfaces - Live It Up (High Tide)
Ilsey - Someone Else
Etta Marcus - Little Wing
Arin Ray - Wait So Long
RealestK - It's You (feat. BIA)
BigXthaPlug - Mmhmm
Megan Thee Stallion - Out Alpha The Alpha
Claire Rosinkranz - Swinging at the Stars
Bazzi - Beautiful World
(G)I-DLE - I Want That
GRiZ - In This World
ODUMODUBLVCK, Bloody Civilian & Wale - BLOOD ON THE DANCE FLOOR
Mau y Ricky - Vas a Destrozarme
Teen Jesus and the Jean Teasers - I Love You
Daisy the Great & illuminati hotties - Time Machine 2
Camylio - running
Knox - I‚Äôm So Good At Being Alone
NCT 127 - Fact Check
Danny Towers & Robb Bank$ - Special Bulletsüïí
Maiya The Don - In Your Hands (feat. Ty Dolla $ign)
IzyBeats - Tipsyüêö
Tkay Maidza - Out of Luck
Jamie Miller - Only Place
Abby Sage - Milk
Mitch Rowland - All The Way Back
Dylan Scott - I'll Be A Bartender
Dogstar - Blonde
New West - Cry For You (Spotify Singles)üêö
Sondae - Every Stepüêö
Mau P - Dress Code
Dorian Electra - Idolize
James Hype & Kim Petras - Drums
Sha Gz - We Do A Lot
RJmrLA & DJ Drama - Dem Freaky Girlsüïí
Ovy On The Drums, Bad Gyal & Ryan Castro - GHETTO PRINCESS
Gemaine - New Movesüêö
Humble the Great - pink dress
CARRTOONS - Spaceships
DPR IAN - Don't Go Insane
Susannah Joffe - Deer in Headlights
Citizen - Can't Take It Slow
TisaKorean - 1500 Shawty‚òëÔ∏è
Samm Henshaw - Jumoke
Yung Bae - Fight My Demons
Namasenda - deathrow bby
HUNNY - ring in ur ear
John Morgan - Remember Us
Florence Arman - Love's The Worst
John R. Miller - Press On
Butcher Brown - MOVE (RIDE) [Feat. Jay Prince] - Single Edit
Bnxn - Best Of Me
Yungeen Ace - Did It First
Anabel Englund - a lesson in chemistry
Deux Visages - Tethered