11:11 - "Me, Chanel & Jameson"
Aazar & Yung Felix - "One Night" ft. Ebenezer & Maia Wright
ADÉ - "Replacements"
Annika Rose - "Naïve"
Bear - "Drop Top" ft. Don Toliver
Billy Bragg - "Can't Be There Today"
Boy In Space - "Forever Young"
Brandy - "Baby Mama" ft. Chance the Rapper
Brett Young - "Lady"
Bruno Major - "The Most Beautiful Thing"
Camila Cabello - "My Oh My (Remix)" ft. DaBaby & Gunna
Chjolo - "Jenova"
Church & AP - "War Outside"
Dagny - "Somebody"
Destiny Rogers - "Kickin' Pushin'"
Doe Boy - "Split It" ft. Moneybagg Yo
Doja Cat - "Say So (Remix)" ft. Nicki Minaj
Don Diablo - "Inside My Head (Voices)"
Duwap Kaine - "Smile""
Evie Irie - "Worst Enemy"
FUTURISTIC & Rittz - "Like This""
Gabbie Hanna - "Glass House"
Gabby Barrett - "Got Me" ft. Shane & Shane
Glass Animals - "Dreamland"
GOON DES GARCONS* - "A24" ft. CUCO
Grace Davies - "Amsterdam"
Hilltop Hoods - "I'm Good?"
Indigo Girls - "Country Radio"
Jean Deaux - "Valid!"
JessB - "Pon It"
Juke Ross - "Atlanta"
Justin Quiles, Daddy Yankee & El Alfa - "PAM"
Khalid - "Eleven (Remix)" ft. Summer Walker
Khruangbin - "Time (You and I)"
KIAN - "Every Hour"
Kid Ink - "Live Forever"
KILLY - "Sailor Moon"
Kill Turbo - "Heart Stop"
Kodaline - "Saving Grace"
Kota the Friend - "BQE" ft. Joey Bada$$ & Bas
Lauren Cimorelli - "Atom Bomb"
Leanna Crawford - "Mean Girls"
Like Saturn - "Stemmed Out""
Lil Tjay - "Ice Cold"
Lukas Graham - "Love Songs"
Luke Combs - "Six Feet Apart"
Lxandra - "Careful What I Dream Of"
Machine Gun Kelly - "Bloody Valentine"
Marshmello & Halsey - "Be Kind"
MAX - "Missed Calls" ft. Hayley Kiyoko
Michael Bublé, Barenaked Ladies & Sofía Reyes - "Gotta Be Patient"
Milky Chance & Jack Johnson - "Don't Let Me Down"
Moby - "Too Much Change" ft. Apollo Jane
Nikki Vianna - "One By One"
O.T. Genasis - "I Look Good"
Passenger - "London in the Spring"
Pollari - "My Promise" ft. Killstation
Quinn XCII - "Coffee" ft. Marc E. Bassy
R3HAB & Timmy Trumpet - "911"
RiceGum - "My Ex"
​ronsocold - "Grandma"
Sad Frosty - "NO TALKIN"
Seeb, GOODBOYS & HVRY - "Unfamiliar"
Sir Sly - "All Your Love"
Skylar Grey - "Dark Thoughts"
Stephen - "I Never Stay in Love"
T-Shyne - "Moncler" ft. Young Thug
Tee Grizzley - "I Spy"
Tinie Tempah - "Moncler" ft. Tion Wayne
Wiktoria - "Come to Me (64567)"
Wrabel - "somebody new"
Yellow Days - "Treat You Right"
YG - "Laugh Now Kry Later""
YNW Melly - "Disturbia"
Yung Tory - "Timeout" ft. Pressa
5/2
Gorillaz - "How Far?" ft. Tony Allen & Skepta
JT Music - "Zarya vs Heavy" ft. Andrea Storm Kaden
Sia - "Saved My Life"
5/3
Caleb Hyles - "It's Been So Long"

5/4
CG5 - "Who I Am"
Dan Bull - "To Valhalla"
Lianne La Havas - "Paper Thin"
Miraa May - "Woman Like Me"
NAV - "Bag"
TAEYEON - "Happy"
5/5
BENEE - "Lownely"
Dirty Projectors - "Lose Your Love"
Fontaines D.C. - "A Hero's Death"
JPEGMAFIA & Denzel Curry - "BALD REMIX"
Martina McBride - "Girls Like Me"
Migos - "Taco Tuesday"
Ra Sossa - "Into That" ft. Lil Uzi Vert
Real Recognize Rio - "Pressure" ft. 21 Savage
Squirrel Flower - "So Hot You're Hurting My Feelings"
Squirrel Flower - "Take It or Leave It"
Wafia - "Pick Me"
5/6
A.CHAL - "Hollywood Love" ft. Gunna
Baauer - "AETHER"
Cass McCombs - "The Wine of Lebanon
Cold Hart - "Tammy and the T-Rex"
Cold War Kids - "1 x 1"
Dan Bull - "Fractured Bones"
EDEN - "Peaked"
Half Moon Run - "Grow Into Love"
Inna - "Sober"
Jacob Banks - "Like You'll Never See Me Again"
Jason Mraz - "Wise Woman"
Kamrin Houser - "TikTokSTAR"
Lil Smaller - "no goodbyes"
Matoma - "Let It Go" ft. Anna Clendening
ONEFOUR - "Say It Again" ft. A$AP Ferg
Peter Manos - "Tennessee"
Quando Rondo - "Get Down"
Raleigh Ritchie - "Aristocrats"
Sammie - "Picky" ft. Rotimi
TeeJay3k - "Veggies"
The Aces - "My Phone is Trying to Kill Me"
The Midnight - "Deep Blue"
Thutmose & Alex Mali - "Foreign"
We Were Promised Jetpacks - "​same mistakes"
Weezer - "Hero"
5/7
​¿​T​e​o​? - "UNI2"
Allan Kingdom - "Blessed"
​C. Tangana - "Guille Asesino"
Charli XCX - "i finally understand"
Demi Lovato - "I Love Me (Emo Version)" ft. Travis Barker
Headie One - "Rose Gold"
Kim Petras - "Malibu"
L Devine - "Don't Say It"
LA Priest - "Beginning"
Lauv - "Love Like That"
Lil Durk - "3 Headed Goat" ft. Polo G & Lil Baby
RMR - "DEALER (Remix)" ft. Future & Lil Baby
seiji oda & lil ricefield - "anime shawty"
UMI - "Introspection"
5/8
6ix9ine - "GOOBA"
Afro B - "Vem Pro Meu Condo" ft. Duda Beat & Tropkillaz
Alec King - "Way Up"
Alex Cameron - "Before Too Long"
Aly & AJ - "Joan of Arc on the Dance Floor"
Ariana Grande & Justin Bieber - "Stuck with U"
Arizona Zervas - "24"
Bandokay - "Patient"
Bankrol Hayden - "Rich Bitch"
Bassnectar - "Nice & Easy" ft. Rodney P
Ben Platt - "So Will I"
Beyond The Black - "Wounded Healer"
‎Bino Rideaux - "BET"
Blanche - "1, 2, Miss You"
Bob Dylan - "False Prophet"
BROCKHAMPTON - "​things can’t stay the same"
Bryce Vine - "Problems" ft. Grady
Buju Banton - "Memories" ft. John Legend
BVDLVD - "TREAT YOU"
CG5 - "Mystery Machine"
Charly Black - "Fuego"
Chelsea Collins - "07 Britney"
Cher - "Chiquitita (Spanish Version)"
Chip - "Lock Down"
Cixqó - "Mr Major"
Clinton Kane - "i don't want to watch the world end with someone else"
D Double E - "Frontline"
Danielle Bradbery - "Never Have I Ever"
Denzel Curry - "IM JUST SAYIN THO"
Doja Cat - "Say So (Original Remix)" ft. Nicki Minaj
Dounia - HAYATI ft. Breakfast N Vegas
Dounia - MY OWN BEST FRIEND ft. Breakfast N Vegas
ELHAE & I.M - "Need to Know"
Ella Eyre - "L.O.V.(e)."
Elliott Trent - "Motions"
Emilie Nicolas - "If I Call"
Fox Stevenson - "Like That"
FUTURISTIC & Chris Webby - "OG Now"
Greyson Chance - "Honeysuckle"
Hannah Grace - "How True Is Your Love"
J.Kelr - "Shine" ft. Guapdad 4000
Jacob Latimore - "Fashion"
Jaebanzz - "Wasted N Laced It"
Jessie War - "Save A Kiss"
Joe Goddard & Hayden Thorpe - "Unknown Song"
Joell Ortiz & KXNG Crooked - "H.A.R.D" ft. MRK SX
John Gabbana - "Not a Sad Song"
Jordan Fall - "5IN" ft. Sean Leon
JP Cooper - "Little Bit of Love"
Josie Dunne - Lost
Kathleen - Seven Miles
Kid Buu - "Talk To Me Nice" ft. 458 Keez
Krawk - "Fácil (Remix)" ft. Hayce Lemsi
Kyd the Band & gnash - "Heartbreak Anthem"
Like Saturn - "I Know I Know"
Lil Kapow - "Dirty Dan"
Lil Loaded - "Raw Shit"
Lil Poppa - "To The Point"
Lil Zay Osama - "Street Nigga" ft. K CAMP
Lindsay Lohan - "Back to Me (Dave Audé Remix)"
​lovelytheband - "​I should  Be Happy"
Mae Muller - "I Don't Want Your Money"
Mak Sauce - "Good Morning (Remix)" ft. NLE Choppa & Lil Yachty
Mavado - "On My Mind"
Moby Rich & Bishop Briggs - "friends*"
Moneybagg Yo - "Me Vs Me"
MUST DIE! - "DON'T EVEN BOTHER" ft. The Pom-Poms
narou - "Her Love" ft. iris
NOTD & Astrid S - "I Don't Know Why"
Now United - "Dana Dana"
NSG - "Porsche"
OMB Bloodbath & Maxo Kream - "Dropout"
Paul Weller - "Village"
Ray LaMontagne - "We'll Make It Through"
Rebecca Black -  "Alone Together " (In Collaboration with Best Buddies)
Rhye - "Beautiful"
Rhys Lewis - "The Sun Will Rise"
Roy Woods - "I Feel It"
Ruben - "Burn Down This Room"
Sad Money, Kaskade & Sabrina Claudio - "Come Away"
Serayah & Blac Youngsta - "Miss You"
Sheppard - "Thank You"
Styles P - "Time"
Tash - "Glow Up"
The Magnetic Fields - "I've Got a Date with Jesus"
Thouxanbanfauni - "Deja Vu"
TM88, Southside & Moneybagg Yo - "Blue Jean Bandit" ft. Future & Young Thug
Tomine Harket - "I'm Gone"
twocolors - "Lovefool"
Wes Period - "Plate Tectonics"
Within Temptation - "Entertain You"
Xanman - "I'm Tryna Yeah"
YEBBA - "Distance"
Yung Pinch - "Long Day"
5/9
CG5 - "Murder Hornet"
JT Music - "Peeping Tom" ft. Rockit Gaming
Kyle Allen - "Sound the Alarms"

5/10
​slowthai - "ENEMY"
5/11
Gavin Haley - "2FU"
Julia Michaels - "Give It To You"
Kodak Black - "Die With You" ft. Jennaske
Lennon Stella - "Summer Feelings" ft. Charlie Puth
Lloyd Banks - "Painted Houses Freestyle" ft. Vado
Mark Ronson - "I Want to See The Bright Lights Tonight" ft. Raissa
Migos - "Racks 2 Skinny"
5/12
Caleb Hyles - "Everything I Wanted"
Justin Rarri - "IN THE BEGINNING"
Khaled - "Delali" ft. GASHI
Overspace - "Gimme Love"
Powfu - "i'll come back to you" ft. Rxseboy & Sarcastic Sounds
Raiden x Chanyeol - "Yours" ft. Changmo & LEE HI
The Beths - "I’m Not Getting Excited"
Tkay Maidza - "Shook"
5/13
A$AP Ferg - "Feel Some Type of Way Freestyle"
Big Wild - "Touch"
Blake Rose - "Rest Of Us"
Chantel Jeffries - "Come Back To Me" ft. Shaylen
Everything Everything - "Arch Enemy"
FLETCHER - "Bitter" ft. Kito
IDK & YungManny - "495" ft. Weensey, Rico Nasty, Big Jam & Big Flock
Keaton Henson - "Career Day"
LANY - "‎good guys"
Nicki Nicole - "Colocao"
slowthai & Kenny Beats - "MAGIC"
The 1975 - "Guys"
​Unlike Pluto - "Overwhelmed"
5/14
Alestorm - "Fannybaws"
Amnesia Scanner - "AS Tearless"
AURORA - "Exist for Love"
Izzy Bizu - "Faded"
Jacob Collier - "All I Need" ft. Ty Dolla $ign & Mahalia
Justine Skye - "No Options"
Lil Skies - "Riot"
Loren Gray - "Cake"
Martin Garrix - "Higher Ground" ft. John Martin
NateWantsToBattle - "Isolated Island"
Random Encounters - "Ice Scream Man"
Ro James - "Plan B" ft. Brandy
RV - "Like Usher"
OneRepublic - "Better Days (Live Quarantine Recording)"
Smokepurpp - "Off My Chest" ft. Lil Pump
Zachary Bryner - "One Way" ft. Noah Bryner & Sammie Morrison

5/15
24kGoldn - "CITY OF ANGELS (Larry Remix)" ft. Larry
AJR & YOUNOTUS - "Bang! (Remix)"
Alice Cooper - "Don’t Give Up"
Anthony Hamilton - "Back Together" ft. Rick James
AUSTN - "Take It All Back"
Biffy Clyro - "Tiny Indoor Fireworks"
Black Fortune - "Off Shit" ft. Fivio Foreign
Bonecage - "Totally Reliable" ft. Rockit Gaming
Cameron Lane - “Burn”
Casanova - "Stress"
Cash Cash - "Gasoline" ft. Laura White
CeeLo Green - "Doing It All Together"
Chloe x Halle - "Do It"
Chris Lake - "I Remember"
Col3trane - "Clutch" ft. Kiana Ledé
Crankdat & void(0) - "Poppin"
Daughtry - "Red Light"
Dizzy Wright & Demrick - "We Ain’t the Same"
Denai Moore - "Motherless Child"
Dre Island - "Still Remain"
DripReport - "Skechers (Remix)" ft. Tyga
EDX - "I Found You (Neptune)" ft. Jess Ball
Elli Ingram - "Flowers"
Erica Banks - "Buss It"
Flipp Dinero - "Jump Off"
G Herbo - "Friends & Foes"
Gavin James - "Boxes"
George Navarro - “When She’s Drinkin’”
Gunna - "Wunna"
Gunplay - "Pyrex Poppin" ft. Rick Ross
Hans Zimmer - "Time (Alan Walker Remix)"
Ida Laurberg - "Why Don't You"
Jake Miller - "SAVED ME"
Jasmine Thompson - "Love For The Lonely"
Johan Lenox & KEY - "Reckless" ft. Young Nudy
Jonas Brothers - "Five More Minutes"
Jonas Brothers - "X" ft. KAROL G
Joyner Lucas & Will Smith - "Will (Remix)"
K. Forest - "Cold Case"
K. Forest - "Stick Around"
Kamaiyah - "Project Baby"
Katelyn Tarver - "Made It This Far"
Katy Perry - "Daisies"
Kelly Clarkson - "I Dare You (Eden Prince Remix)"
Kip Moore - "Red White Blue Jean American Dream"
Kota Banks - "Snip Snip"
Krewella & Nervo - "Goddess" ft. Raja Kumari
Kygo & OneRepublic - "Lose Somebody"
Lil Keed - "WAVY"
Like Saturn - "Munky Funk"
Lolo Zouaï - "Alone With You"
Maisie Peters - "The List"
MALINDA - "More With You"
Max Frost - "Sayonara"
Melii & Smoove’L - "BDE"
Neil Young - "Try"
Off Bloom - "Mona Lisa"
Oh Wonder - "Oceansize"
Pia Mia - "Princess"
Problem - "Janet Freestyle (Remix)"
R I L E Y - "DEAD & OVER" ft. blackbear
REASON - "Pop Shit" ft. ScHoolboy Q
Rexx Life Raj - "Thank You (4:18)"
Rini​ - "Bedtime Story"
Rob Markman - "Move" ft. Saint Pat Beatz
slowthai - "BB (BODYBAG)"
Sofi Tukker & Gorgon City - "House Arrest"
Stephen Puth - "Watching You Walk Away"
Tiësto - "Lose You" ft. ILIRA
Tory Lanez - "Temperature Rising"
Trippie Redd - "Excitement" ft. PARTYNEXTDOOR
UnoTheActivist - "Inches"
Volumes - "Pixelate"
WILLOW & Jahnavi Harrison - "Surrender (Krishna Keshava)"
X Ambassadors, K.Flay & grandson - "Zen"
Yuna - "Stay Where You Are"
Yungeen Ace - "400 Shots"
Yung Pinch - "Trap Mode"
ZHU & Tinashe - "ONLY"
5/16
645AR - "NO SOMBRERO"
Lil Playah - "Nah Foreal"
5/17
DHeusta - "Darkest Desire" ft. Dawko
The Stupendium - "These Hallowed Wings"

5/18
Cammwess - "Save It For Tomorrow"
Cammwess & John Legend - "Rocket Man"
Florida Georgia Line - "Second Guessing"
Joey Dosik - "23 Teardrops"
Khruangbin - "So We Won’t Forget"
KYLE - "What It Is"
Lianne La Havas - "Can’t Fight"
Louis The Child & Vera Blue - "Nobody Like You"
Micah Iverson - "Butterflies"
Micah Iverson & Kelly Clarkson - "I Run to You"
Remo Drive - "Ode to Joy 2"
Rockit Gaming - "Hello World"
SAINt JHN - "Ransom"
SoMo - "Dime"
SVDDEN DEATH - "Confusion Spell"
Todd Tilghman - "Long Way Home"
Todd Tilghman & Blake Shelton - "Authority Song"
Toneisha Harris - "My Superhero"
Toneisha Harris & Blake Shelton - "Don't Stop"
Thunderstorm Artis - "Sedona"
Thunderstorm Artis & Nick Jonas - "You'll Be In My Heart"
5/19
Bad Cop/Bad Cop - "Pursuit of Liberty"
BlocBoy JB - "No Chorus Pt. 12" ft. Tay Keith
​​guccihighwaters - "rope"
IDLES - "Mr. Motivator"
jxdn - "Angels & Demons"
Madeline Kenney - "Sucker"
Nick Jonas - "Until We Meet Again"
Phoebe Bridgers - "I See You"
Sébastien Tellier - "Stuck in a Summer Love"
Snoop Dogg - "I Wanna Go Outside"
5/20
Alex Mali - "I Know"
Bombay Bicycle Club - "I Can Hardly Speak (Spotify Singles)"
Bombay Bicycle Club - "Lose You to Love Me"
Drainpuppet - "Reflection" ft. Evan Higgins
Dream Wife - "So When You Gonna..."
Fetty Wap - "Pretty Thang"
Foxes - "Love Not Loving You"
Gracie Abrams - "Long Sleeves"
Greer - "Aeroplane"
Leah McFall - "Rubber"
Lloyd - "Slow Wine Bass Line" ft. Teddy Riley
Lloyd - "Slow Wine Bass Line (Extended Version)" ft. Teddy Riley
Matt Berninger - "Serpentine Prison"
Neon Trees - "New Best Friend"
Northlane - "Enemy of the Night"
Petit Biscuit & Shallou - "I Leave Again"
Ricky Himself - "SCREAM!" ft. Kailee Morgue
Sia - "Together"
Unlike Pluto - "Mindless Bliss"
5/21
Aitch - "RAW"
Ariel Pink - "Iron Worrier"
Brasstracks & Col3trane - "Missed Your Call"
deadmau5 & The Neptunes - "pomegranate"
​DMB Gotti - "Peter Piper (Remix)" ft. Toosii
Ellie Goulding - "Power"
HAIM - "Don’t Wanna"
Max B - "Goodman"
Mulatto - "He Say She Say"
Poundz (UK) - "Honey"
Psy.P & Higher Brothers - "Bad Habits"
Ro James - "Too Much" ft. Miguel
Stray Kids - "SLUMP (English Version)"
Stray Kids - "TOP (English Version)"
Sullivan King, Kai Wachi & GG Magree - "Flatline"
TRACE - "Hard Times"
The Weeknd - "In Your Eyes (Remix)" ft. Doja Cat

5/22
$NOT - "Human" ft. Night Lovell
2Scratch - "Afterlife"
Andrew Rayel & Roxanne Emery - "Never Going Down"
Ann Marie - "Mind Games"
BabyJake - "MadHappySad"
Bassnectar - "Rise & Shine"
Bassnectar - "Rewind the Track" ft. Ashel Seasunz
Brett Eldredge - "Good Day"
Cady Groves - "Bless My Heart"
Christopher - "Leap Of Faith"
Clara Mae - "Overused" ft. gnash
Cobi - "Don’t Stop"
Cole Swindell - "Single Saturday Night"
DBangz - "Prove"
DC The Don - "Jesus Can’t Save You"
DeathbyRomy - "Kiss Me Goodbye"
Disclosure - "ENERGY"
Dwn2earth - "Dakota Fanning"
Ea Kaya - "Skin and Bones"
Eli Sostre - "Curfew"
Emiway & Lexz Pryde - "New World" ft. Snoop Dogg
Eric Leon & TroyBoi - "Lemme See"
Far East Movement - "We Are the Truth" ft. Sha Sha Jones
Foster the People - "Lamb's Wool"
Fredo Bang - "Top"
G-Eazy - "Free Porn Cheap Drugs"
Gin Wigmore - "Hangover Halo"
GNAR - "Brand New Booty"
Grace Potter - "Eachother" ft. Marcus King, Jackson Browne & Lucius
GRACEY & Ruel - "Empty Love"
​grandson & Zero 9:36 - "Again"
Green Day - "Dreaming"
iann dior - "Prospect" ft. Lil Baby
IDK & A$AP Ferg - "Mazel Tov"
ISA - "Walk Like Jesus"
Joell Ortiz & KXNG Crooked - "Memorial Day"
JT Music - "Debts to Pay" ft. Andrea Storm Kaden
Juke Ross - "Higher"
Kamaiyah - "Go Crazy"
Kap & Kap G - "Kenan & Kel"
Kennedy Rd. - "Afraid Of"
Krawk - "Calma Bro (Remix)" ft. Awich
Kygo & Valerie Broussard - "The Truth"
Lady Gaga & Ariana Grande - "Rain On Me"
Like Saturn - "2091"
Lisa Cimorelli - "Fading Away"
LUCKI - "TUNE & SCOTTY"
Ludacris - "S.O.T.L. (Silence of the Lambs)" ft. Lil Wayne
Madina Lake - "The Chasing Ones"
Mapei - "Lyah"
Mariah the Scientist - "RIP"
Migos - "Need It" ft. YoungBoy Never Broke Again
Miraa May - "Baby"
NLE Choppa - "Different Day"
Olivia O’Brien & 24kGoldn - "Josslyn"
Oliver Heldens - "Rave Machine"
OneRepublic & KHEA - "Better Days"
R3HAB & HRVY - "Be Okay"
Rockit Gaming - "Jett"
Rod Wave - "And I Still"
Scribz Riley - "Impress Me" ft. Headie One
SG Lewis & Master Peace - "Chemicals (Remix)"
Shenseea - "Wasabi"
SHY Martin - "Nobody Likes Moving On"
SICK INDIVIDUALS - "Higher"
Sinéad Harnett - "Quarantine Queen"
T-Lost - "Thanos Car Remix Remix Remix Remix" ft. Yung Craka
Teyana Taylor​ - "Bare Wit Me"
Teyana Taylor​ - "Made It"
The Naked and Famous - "Death"
Tove Lo - "sadder badder cooler"
Tritonal & Brooke Williams - "Someone To Love You"
Twin XL - "Melt"
Two Friends - "Looking at You" ft. Sam Vesso
UMI - "Open Up"
UnoTheActivist & Travis Barker - "Taste The Rainbow"
Wallows - "With a Little Help From My Friends"
Warhol.SS - "Blicks"
Weiland - "​slilppnyhik6febe.​onion"
Yung Pinch - "Be Yours"
Yung Trench - "Fantasy"
5/25
Boyz II Men - "Love Struck"
JPEGMAFIA - "CUTIE PIE!"
5/24
Dave East - "My Loc"
Jack Leopards & The Dolphin Club - Look What You Made Me Do
5/26
Ace Hood - "12 O’Clock" ft. Jacquees
Cigarettes After Sex - "You’re All I Want"
Hudson Thames - "Chess"
Joseph Black - "see you later"
Lil Yachty - "Split / Whole Time"
Marlon Craft - "Loved"
Maverick Sabre - "Don’t You Know by Now"
Oliver Tree - "Bury Me Alive"
twenty one pilots - "Level of Concern (live from outside)"

5/27
Almondmilkhunni & Flo Milli - "Cherry"
Bright Eyes - "One and Done"
Celeste - "I Can See The Change"
Dolly Parton - "When Life Is Good Again"
JIMMY EDGAR - "BENT" ft. Hudson Mohawke
Kevin Gates - "Grandmotha Grave"
LPX - "Delayed Gratification"
Lucky Daye - "Shoulda" ft. Babyface
Melanie C - "Blame It On Me"
Robin Thicke - "Forever Mine"
Sammie - "All Night"
Sevdaliza - "Joanna"
Tank and the Bangas - "For André"
The Lemon Twigs - "Moon"
Unlike Pluto - "Painted Dreams"
5/28
645AR - "FINGER ROLL" ft. K$upreme
Chevy Woods - "Make It Last"
Flatbush Zombies - "​iamlegend"
Kyle Allen - "Vanished"
Lady Gaga & BLACKPINK - "Sour Candy"
Nathy Peluso - "Buenos Aires"
Tayla Parx - "Dance Alone"
The Living Tombstone - "Goose Goose Revolution"

5/29
6LACK - "ATL Freestyle"
8 Graves - "Begging to Bleed"
Ali Gatie - "Running on My Mind"
Aminé - "RiRi"
Andra Day - "Make Your Troubles Go Away"
Ashley Tisdale - "Lemons"
Aston Fenly & Paris Shadows - "Pop & Reload"
Baby Goth - "I Do"
Basshunter - "Angels Ain't Listening"
Bizzy Banks​ - "Dont Start Pt. 2"
boy pablo - "hey girl"
Brian McKnight - "Bad"
CG5 - "Run n' Gun"
Christian Leave - "No Use"
DaniLeigh - "Dominican Mami" ft. Fivio Foreign
Dizzy Wright & Demrick - "Don’t Worry"
DUCKWRTH - "Find a Way" ft. Alex Mali & RÅDĮØ ÅHŁËË
Dylan Scott - "Panama City Weekend"
Ella Eyre - "Dreams" ft. Yxng Bane
Four of Diamonds & Mr Eazi - "The Writer"
Galantis, Ship Wrek & Pink Sweat$ - "Only A Fool"
GASHI - "Paranoid"
glaive - "life is pain"
Grey - "For the Night"
Griff - "Forgive Myself"
Gucci Mane - "Both Sides" ft. Lil Baby
Gunplay - "PAY THE PIPER"
Hayley Kiyoko - "Mr. Brightside"
Jake Bugg - "Rabbit Hole"
Jason Mraz - "You Do You"
Jay Critch & Tank God - "Execute"
Jban$2Turnt - "Foreign"
Jordin Sparks - "Legal or Drinking"
Jordin Sparks - "Unknown"
Juice WRLD & Trippie Redd - "Tell Me U Luv Me"
Julie Bergan - "Commando"
Kap G - "ICE Baby"
Katy Perry - "Daisies (MK Remix)"
Kayla Nicole - "Think About Me"
Kid Trunks - "Do you know what is right?" ft. Noah Cyrus
Landon Cube - "Groceries" ft. Lil Keed
Like Saturn - "Levitation Spell"
LilCockPump - "X Games Mode" ft. WARLOCC
Louis the Child & Drew Love - "Free (Party Favor Remix)"
Madison Beer - "Selfish (Alan Walker Remix)"
Max Perry & Flipp Dinero - "Turned Into Sumthin"
Ne-Yo & Jeremih - "U 2 Luv"
NGHTMRE & Subtronics - "Nuclear Bass Face" ft. Boogie T
No Rome, beabadoobee & Jay Som - "Hurry Home"
Now United - "Let The Music Move You"
Pasto Flocco - "McLovin"
Phoebe Ryan - "Reality"
PRXJEK - "CUT THE GRASS (FREESTYLE)"
Quinn XCII - "A Letter to My Younger Self" ft. Logic
Ray LaMontagne - "Strong Enough"
Rhys Lewis - "Good People"
RMR - "I’M NOT OVER YOU"
Rockit Gaming - "Nightmare"
Roman Kouder & Marian Hill - "Bonjour"
ROSALÍA & Travis Scott - "TKN"
Ruel - "Painkiller (Remix)" ft. Denzel Curry
SAINt JHN - "Roses (Remix)" ft. Future
Saint Raymond - "Right Way Round"
Scott Storch - "Fuego Del Calor" ft. Ozuna & Tyga
Sean Leon - "Guillotine"
Shoreline Mafia - "RIDE OUT" ft. Lil Yachty
Skip Marley - "No Love"
Smokepurpp & Ronny J - "It’s Whatever"
Stephen - "TRACER"
The Hunna - "If This is Love" ft. phem
The LOX - "Gave It To Em"
Thouxanbanfauni - "Domino"
Tion Wayne - "I Dunno" ft. Dutchavelli & Stormzy
Tones and I - "Ur So F**kInG cOoL"
Travis Barker & Wiz Khalifa - "Drums Drums Drums"
TryHardNinja - "When the Siren Sounds"
Wes Period & Theophilus London - "Plate Tectonics (Remix)"
Winona Oak & Robin Schulz - "Oxygen"
X Lovers - "Mad World"
Young Dolph - "RNB" ft. Megan Thee Stallion
Young Mountain - "James Albert"
Yung Bae, bbno$ & MAX - "Bad Boy" ft. Wiz Khalifa
Yungeen Ace - "I’m the One"
5/30
Cimorelli - "All the Days of My Life" ft. Katherine Cimorelli
DHeusta - "Bad Ending"
IRIS - "Plague"
JT Music - "Dead to Me"

5/31
2KBABY - "Emotionally Scarred Freestyle"
​cupcakKe - "Lemon Pepper"
M.E.T.A.L. - "The World In Crisis"5