Lizzo - Special (feat. SZA)
Central Cee - Me & You
d4vd - Placebo Effect
BeyoncÃ© - CUFF IT - WETTER REMIX
Dove Cameron - We Go Down Together (with Khalid)
The Kid LAROI - Kids Are Growing Up (Part 1)
Luke Combs - Love You Anyway
Jason Derulo - Saturday/Sunday
Mae Stephens - If We Ever Broke Up
Megan Moroney - I'm Not Pretty
Lauren Spencer Smith - Best Friend Breakup
Lovejoy - Call Me What You Like
Ayra Starr - Sability
Daniel Caesar - Let Me Go
Gracie Abrams - Amelie
French Montana - RATATAAAAA
NAV - Lately
Bailey Zimmerman - Fix'n To Break
Tove Lo - Borderline
Ashnikko - You Make Me Sick!
YG - Let's Ride (feat. YG, Ty Dolla $ign, Lambo4oe)
Jax Jones - Whistle (feat. Calum Scott)
BoyWithUke - Rockstar
Harriette - Goodbye Texas
Grupo Marca Registrada - Di Que Si
Bakar - Good News
Jessie Murph - What Happened to Ryan
BENEE - Green Honda
Zolita - Crazy Ex
Leith Ross - (You) On My Arm
Kelela - Enough for Love
MEDUZA - Pegasus
Pierce The Veil - Death Of An Executioner
Linkin Park - Lost
JAWNY - fall in love
Saint Harison - homies
Daughter - Party
Indigo De Souza - Younger & Dumber
Chiiild - Antidote
Lucky Daye - Careful
Babyface Ray - Ron Artest
Hitkidd - You The Type
LUM!X - Forget You (with Gabry Ponte)
Mau y Ricky - Miami
Kevin Gates - Breakfast
Logic - Paradise II (feat. Norah Jones) - Single Version
RIZ LA VIE - Haven
Sam Hunt - Walmart
Beck - Thinking About You
Abraham Alexander - Tears Run Dry
Chase Rice - Oklahoma (feat. Read Southall Band)
Ali Gatie - All Comes Back To You
Depeche Mode - Ghosts Again
salute - Wait For It
Marshmello - Eternal
M83 - Amnesia
Andy Shauf - Halloween Store
Jordan Ward - CHERIMOYA
Kash Doll - OH BOY
Danny Towers - Florida Water (feat. Luh Tyler)
Anyma - Eternity
Jessie Ware - Pearls
Sabrina Claudio - Nurture
Zacari - Motions
Jeremy Zucker - internet crush
Limoblaze - TwoðŸ•’
Devon Gilfillian - All I Really Wanna Do
Devon Gabriella - get clean
Mia Wray - Happy
flowerovlove - Love You
Isaia Huron - Patient (02)
G Perico - Action
3AM - EmeycÃ© (feat. Danny Ocean)
ERNEST - This Fire
Oscar Maydon - Una Mentirosa
BigXthaPlug - Levels
Ghostluvme - Fact (feat. Lil Uzi Vert)
Masego - Two Sides
Eddie Benjamin - All for Nothing
Franklin Jonas - Cocaine
Barrie - Races
Jill Barber - Helium
RINI - My Luv
Ari Abdul - Bored
LANNDS - Bonfire
Flume - Counting Sheep (V2) [2018 Export Wav]
Rebecca Black - Performer
YEÐ˜DRY - Herrera
Mnelia - White Lies (feat. Kwengface)
Eric Bellinger - Sum 2 See
Nasty C - Blackout
Harry Romero - Inside My Mind
Maeta - S(EX)
Yaya Bey - exodus the north star
Tennis - Hotel Valet
Rowena Fysx - I Love Being Invisible
Priscilla Block - Little Bit
Savannah Conley - More Than Fine