Shawn Mendes - There's Nothing Holdin' Me Back
Luis Fonsi & Daddy Yankee - Despacito feat. Justin Bieber
Lana Del Rey - Lust for Life feat. The Weeknd
Dua Lipa - Lost In Your Light feat. Miguel
Blackbear - make daddy proud
Paramore - Hard Times
Big Boi - Mic Jack feat. Adam Levine
Incubus - Loneliest
Beatrich - About
Sigrid - Plot Twist
Lady Gaga - The Cure
COIN - Feeling
Jillian Jacqueline - Reasons
MÃ˜ - Nights With You
Youngr - Monsters
Bruno Mars - That's What I Like feat. Gucci Mane
DJ Shadow - Systematic feat. Nas
Tash Sultana - Murder to the Mind
Amy Shark - Drive You Mad
Aaron Espe - Yourself
Shallou - Fictions
AFSHeeN - Pull Me from the Waves feat. Nisha
Linkin Park - Heavy (Nicky Romero Remix) feat. Kiiara
Blackbear - hell is where i dreamt of u and woke up alone
Yoke Lore - Only You
London Grammar - Oh Woman Oh Man
Joywave - Content
Rise Against - The Violence
Have Mercy - Good Christian Man
Two Friends - Emily feat. James Delaney
Flor - overbehind
Bleachers - Hate That You Know Me
Brad Paisley - Drive of Shame feat. Mick Jagger
MisterWives - Drummer Boy
Allday - Baby Spiders feat. Mallrat
Anne-Marie - Ciao Adios (Thomas Rasmus Chill Mix)
Mike Perry - Body to Body feat. Imani Williams
Big Boi - Kill Jill feat. Killer Mike & Jeezy
Jessie Reyez - Blue Ribbon feat. Tim Suby
D.R.A.M. - Gilligan feat. A$AP Rocky & Juicy J
Malay - Shaolin's Theme / Pray feat. 6LACK
Omarion - BDY ON ME
Alex Aiono - Question
Brandon Beal & Olivia Holt - Paradise
Kid Ink - Lottery
RINNGS - Cutting the Cloth
Pool Cosby - Lookin' Up feat. valentein
Jacob Banks - Mercy
NoMB & New Mystics - Can't Catch Me
Chris Stapleton - Last Thing I Needed, First Thing This Morning
Stalking Gia - Siren
Airling - Give Me All You Got
Jasmine Thompson - Wonderland (intro)
Biotin Babies - Not Enough
Anik Khan - Kites
GOLDHOUSE - Sex On Me
Thrupence - Alethea feat. Edward Vanzet
Shawn Hook - Reminding Me feat. Vanessa Hudgens
Panama - Hope for Something
Lo Moon - Loveless (Hudson Mohawke Remix)
Joe Goddard - Electric Lines
Jazz At Lincoln Center Orchestra - 2 Degrees East, 3 Degrees West feat. Wynton Marsalis & Jon Batiste
Haux - Touch
Amtrac - Some of Them feat. MELI
Zipper Club - Regrets1