Wale - My P.Y.T feat. Sam Sneak
Coldplay - Hymn for the Weekend (SeeB Remix)
Adele - Send My Love (To Your New Lover)
Midnight To Monaco - One in a Million
Astrid S - Hurts So Good
Benjamin Francis Leftwich - Mayflies
Broods - Couldn't Believe
Glass Animals - Life Itself
Anne-Marie - Alarm
Felix Jaehn & Hitimpulse - Cut the Cord
Great Good Fine OK - Always
AREA21 - Girls
T.I. - Dope feat. Marsha Ambrosius
Nightly - Xo
The Hunna - We Could Be
Huntar - 4AM
Jez Dior - Forever feat. Elijah Blake
Lonely The Brave - Dust & Bones
Highasakite - Deep Sea Diver
Phoebe Ryan - Boyz n Poizn
Steve Aoki & Boehm - Back 2 U feat. Walk The Moon
Astrid S - Atic
Kaskade & Felix Cartal - Fakin It feat. Ofelia K
Buster Moe - Shoot Me
Banks & Steelz - Love and War feat. Ghostface Killah
The Aces - Stuck
Krewella - Marching On
Brand New - I Am a Nightmare
Volbeat - Seal the Deal
Jamie N Commons - Let's Do It Till We Get It Right
The War On Drugs - Touch of Grey
Julien Baker - Sprained Ankle
Ria Mae - Ooh Love
Yuna - Best Love
RKCB - Elevated
Seramic - Found
Emily Vaughn - What Do You Want
Leagues - Dance With Me
Car Seat Headrest - Fill in the Blank
Cappa - I'm Good
Matt Wertz - Lemonade
Declan McKenna - Bethlehem
Liv Dawson - Tapestry
Elohim - Sensations
Brandyn Burnette - Karma
Monica Heldal - Coulda Been Sound
Jackson Michelson - Boys Will Be
Brett Dennen - Where We Left Off
Bea Miller - Yes Girl
Halsey x Lido - Tokyo Narita Freestyle
Dawin - Throwback
Madi Wolf - Lucky
Ariana Grande - Dangerous Woman2