Tori Kelly - Nobody Love
Big Data - Snowed In (feat. Rivers Cuomo)
Charli XCX - Doing It (feat. Rita Ora)
Father John Misty - True Affection
Lord Huron - Fool for Love
Laura Welsh - Undiscovered
Alabama Shakes - Don't Wanna Fight
Rathborne - Last Forgiven
Unknown Mortal Orchestra - Multi-Love
AWOLNATION - I'm On Fire
Big Sean - Blessings
NERVO - It Feels
Olly Murs - Up
Madeon - Pay No Mind
Sheppard - Find Someone
Dead Sara - Mona Lisa
James Bay - Move Together
The Weeknd - Where You Belong
James Davis - Co-Pilot
Karen O - The Moon Song - Live
Lucie Silvas - How To Lose It All
Kitty, Daisy & Lewis - No Action
Cody Simpson - Flower
Who Is Fancy - Goodbye
Kid Astray - Still Chasing Nothing - Radio Edit
Murder By Death - Strange Eyes
The Districts - Bold
Torche - Bishop in Arms
Dustin Kensrue - Back to Back
RAC - We Belong - Odesza Remix
OK Go - You're a Fucking Nerd and No One Likes You
S. Carey - Bullet Proof.. I Wish I Was
Other Lives - Reconfiguration
Vic Mensa - Down On My Luck
NEEDTOBREATHE - Brother - feat. Gavin DeGraw
Royal Tongues - Rollin' On
Menace Beach - Come On Give Up
Incubus - Absolution Calling
The Stone Foxes - Cold Like A Killer
Lower Dens - To Die in L.A.
Hot Chip - Huarache Lights
Susanne Sundfør - Fade Away
The Dø - Sparks
Mew - Satellites
Villagers - Courage
Rhiannon Giddens - Black Is the Color
Foy Vance - Guiding Light (Live)
Striking Matches - When The Right One Comes Along
The Weepies - Sirens
The Staves - Black & White
Two Gallants - Katy Kruelly
Ibeyi - Mama Says - Live From Spotify London
Brodinski - François-Xavier - feat. Young Scooter
Madonna - Iconic
Magic Giant - Glass Heart
MOD SUN - Howlin' At The Moon
Migos - One Time
Hedge Fund - Object of My Affection
The Soft Moon - Far
James Davis - Better Than You Are
Daniel Johns - Aerial Love
Emile Haynie - Come Find Me
All We Are - Feel Safe
Axwell^Ingrosso - Something New - Amtrac Remix
Shake Shake Go - Doors To Heaven - Live From Spotify Paris
Ricky Martin - Adiós