Darell, Farruko - Caliente
Alejandro Sanz, Nicky Jam - Back In The City
*Ivy Queen - Pa'l Frente y Pa' Tras
*El Bebeto - Viajes Para Marte
*Reynier Perez, Septeto Acarey, Gilberto Santa Rosa - Enamórate Bailando
Río Roma - Deberías Estar Aquí
Eladio Carrión, Zion - Mi Error
Dalex, Rafa Pabön, Sech, Cazzu, Feid, Khea, Lenny Tavarez - Pa Mí (Remix)
*Carlos Baute - Perdido (feat. Joey Montana)
Y La Bamba - My Death
Esteman - Solo
Ventino - Ya Te Perdoné
Santiago Cruz, Manuel Medrano - Cómo Haces
Bryant Myers, Miky Woodz - Te Descubrí
iZaak - Hey Shorty 2 (feat. Brray & Chris Wandell)
*Mr. Don - Sin Tu Amor
*Diego Herrera - Vuelve Vuelve
Cauty - Pos Claro
*18 Kilates - Ya Fue
*Seth Condrey - En Cada Latido
MDBCrew - Classic (feat. C.R.O)
*Muerdo - Llegué hasta ti (feat. Juanito Makandé)
*Abraham Vásquez, T3r Elemento - El De Las Dos Pistolas
*Fuera De Serie - Todavía No Sabe
*Bustamante, Ana Guerra - Desde Que Te Vi
*Nacha Pop - Sal y Limón
Allison - Matar o Morir (En Vivo)
*Jeimy Osorio - Quizás
*Techy Fatule - Amor para la Historia
Camela - Cuando zarpa el amor (feat. Juan Magán)
*Kiko Rodríguez - Lloro
FMK - Parte de Mí (feat. Lit Killah)
*Gaviria - Maradona
*Yulien Oviedo, Gente De Zona - Por Qué Será???
Adexe & Nau - De Verdad (feat. Abraham Mateo)
*Jacob Forever, Lenier, Lusin Pro - Donde Tú Estés (Remix)
*Danilo Montero - ¿A Quién Tengo Yo? (En Vivo)
*Daniela Galeano - Me Acerco a Ti
*La Reforma - Insuperable
*Lucah - Se Supone
*Chucho Rivas - Cuando Te Veo
*Meteoros, Emmanuel Horvilleur - Chica en Buenos Aires
*Arturo Jaimes Y Los Cantantes - De Tiempo Completo
Lil Santana - Nunca Pichea
Omega - Corazón En Pedazos
*Roberto Antonio - La Vida Es Una[Novedades Viernes Sudamérica]
Alex Rose, Almighty - Khalifa
*GS, Khea, Kyke, Smoky, Alexis Chaires - Loco
**Los Palmeras, Andrés Calamaro - Asesina
*Banda XXI - Tu Falta de Querer (En Vivo) [feat. Viru Kumbieron]
Jd Pantoja - Todo y nada
Lucho SSJ, DAM - Goten
*Yami Safdie, Emanero - Por Cobarde
Bardero$ - Droga
*Benjamin Walker - Y Arderán
*Grupo 5 - No Te Perdonaré
*Vozenoff - La Oportunidad
*Austin Fernandez - Como Hago
*Alfonso El Pintor - De a Poquito
*Ale Ceberio, Marcos Bainotti - Lo Que Yo Más Quiero (En Vivo)
*Daniel Cardozo - Ahora Llora
*Coqeéin Montana, Jeebz, Hot Plug Beats - Tabú
*Barilari - Infierock
*Attaque 77 - Lobotomizado (feat. Campino)[Novedades Viernes España][Novedades Viernes México]
Reik, Maluma - Amigos Con Derechos (Versión Pop)
*Maena - No Le Gusto Tanto
*Jafú - Faltas Tú
*Jawy Mendez - No Le Digas
*Alex Soto - Claro
Maite Perroni - Love
*Pandora - El Amor de Su Vida
*Los Rumberos, Alex Cuba - Riéndose de Mí
La Plebada - Placoseo Como Se Debe
*Los Master Plus - ALV
AQUIHAYAQUIHAY - Llámame
*Super Llamas, Aleks Syntek - Corazones Invencibles
El Otro Polo - Bajo el Sol
*Haydée Milanés, Pancho Céspedes - A mi lado
*Erick Mendoza - Intenso Valentín
*KICKBOMBO, Leby, El Chete - Como Bender
*Micca Mont - Aquí Ahora
*Dylan Thomas. - Luces Violeta[Novedades Viernes Colombia]Canciones sin transcribir = 54