ChocQuibTown, Zion & Lennox, Farruko - Pa Olvidarte (Remix) [feat. Manuel Turizo]
Luis Fonsi - Apaga La Luz
Ozuna - Cama Vacía
Feid, Sech - Sígueme (Remix)
Anitta, MC Kevinho - Terremoto
*La Original Banda El Limón de Salvador Lizárraga - Y Ahora Te Vas
*Juan Pablo Vega - Fishaman (feat. Elkin Robinson)
Messiah - Novios
*Alfredo Olivas - A Estas Horas
*Lenin Ramírez - Hierba de Receta (feat. T3R Elemento, Oscar Cortez)
Paola Jara - Como Si Nada (feat. Jessi Uribe)
*Yahir - Entre Nosotros Dos
Juan Magán - Claro Que Si (feat. Hyenas, Mohombi, Yasiris)
*Ls Duran - Contener Tu Voz
*Pj Sin Suela - La Pelúa
Juhn - Recuerdos
Mariah, Casper Mágico - Lo Prohibido
Malu Trevejo - Como Tú Me Quieres
El Alfa - El Hombre
*María Del Pilar - Milagrito
*Cheyo Carrillo - No Podemos Ser Amigos
Leslie Grace - Call the Shots
Farina, Tokischa - Perras Como Tú
*JFab & Paola Fabre - Mia (Bachata Version)
*Alih Jey, Cuñao - Mi Debilidad
*Rodrigo y Gabriela - Echoes
*Alfredo Rodriguez, Pedrito Martinez - Duologue
*Cecilia Krull, Mala Rodríguez - Adnus Di (Banda Sonora Original de la Serie Vis a Vis) (Urban Version)
*Apache - Oído al Tambor
*Camy G - No Soy Así (Bailando)
Sabino - Los Enamorados (feat. Loli Molina)
MC Davo - HBO (feat. Felp 22, Recycled J)
*Taylor Diaz - Besándote
*Banda Tierra Sagrada - El Corrido de Gabino (feat. Marco A. Flores)
Carlos Sadness - Isla Morenita
*Los De Guamuchil - Éxtasis (feat. Omar Ruiz)
*Kanales - Hombre de 14 Años
Jackie Mendoza - De Lejos
*Demarco Flamenco - Te entiendo
*Divino Niño - Foam
*Juan Carlos Ensamble - Otra Vez
*Kaydy Cain - Mi Cibernovia (feat. Israel B, Ac3)
Rels B - HEY, SHORTY![Novedades Viernes Sudamérica]
*Delsole, Kodigo - Me Equivoqué
*Kevin Johansen - Solo Le Dije
*Fabo, Valen Madanes - Amores Como el Nuestro
*Pedro Aznar, Manuel García - Canción para Mañana
*Tu Vicio - Amantes
Frijo - La Perdí
Joaquín Sabina - Coplas Patéticas
D-Enyel, Ñengo Flow - Patrón
Nissa - Safari
*Ray Callao - Rebeca
*BlackDali - Yo Soy
*Bandana - En la Punta de la Lengua
*Cuentos Borgeanos - Chau!
*Gollo - Buscame
Homer El Mero Mero - Los Mismos de Siempre
Coqueéin Montana, Big Zaes - Combo Diario
*Ale Ceberio - El Camison
*Fidel Nadal, Van-Clive - Veni
Mark B, MC Davo, Pacho El Antifeka, Rochy RD - Un Nuevo Día
*Daniel Cardozo - No Te Encuentro
*Kiddo Toto, Gandu - Pary 10[Novedades Viernes España][Novedades Viernes México][Novedades Viernes Colombia]Canciones sin transcribir = 38