Fort Minor - Welcome
Selena Gomez - Good for You feat. A$AP Rocky
Foals - What Went Down
Atlas Genius - Molecules
Carly Rae Jepsen - Emotion
Tori Kelly - I Was Made For Loving You feat. Ed Sheeran
Powers - Loved By You
Jidenna - Classic Man (Remix) feat. Kendrick Lamar
DJ Khaled - Hold You Down feat. Chris Brown, August Alsina & Jeremih
Twin Shadow - To the Top
High Dive Heart - Vintage
Lianne La Havas - What You Don't Do
Leo Kalyan - Fingertips
Trey Songz - Serve It Up
Flo Rida - I Don't Like It, I Love It (Noodles Remix) feat. Robin Thicke & Verdine White
Afrojack - SummerThing! feat. Mike Taylor
Cayucas - Big Winter Jacket
Iron & Wine - This Must Be the Place feat. Ben Bridwell
Wolf Alice - Bros
David Ramirez - Harder to Lie
Miya Folick - Strange Darling
Years & Years - Foundation
Gengahr - Powder
Leon Bridges - Pull Away
Good Old War - Don't Forget
Elijah Blake - Everyday
Robyn & La Bagatelle Magique - Love Is Free feat. Malice
The Legends - Keep Him
Hilang Child - Thule
Ratatat - Abrasive
Desaparecidos - MariKKKopa
Obie Trice - Good Girls
Little Boots - No Pressure
Janet Jackson - No Sleep
Omarion - I'm Up feat. Kid Ink & French Montana
The Internet - Girl feat. KAYTRANADA
Steven a. Clark - Not You
The Glitch Mob - Better Hide, Better Run feat. Mark Johns
Slayer - Repentless
Breaking Benjamin - Hollow
Hunter Hayes - Young and In Love
Mike Posner - Not That Simple
Kacey Musgraves - Biscuits
Mac Demarco - Another One
Thundercat - Them Changes feat. Flying Lotus & Kamasi Washington
Class Actress - GFE
Widowspeak - All Yours
Grouplove - No Drama Queen
The Heydaze - Dumb1