Halsey - Graveyard
Drake - Behind Barz - Bonus
Major Lazer - Que Calor (feat. J Balvin & El Alfa)
Charlie Puth - Mother
FKA twigs - holy terrain
A Boogie Wit da Hoodie - Mood Swings
Russ - RENT FREE
French Montana - Suicide Doors (feat. Gunna)
Rex Orange County - 10/10
OneRepublic - Somebody To Love
Cautious Clay - Erase
Charli XCX - White Mercedes
SONIA - Joyride
Sam Fender - Call Me Lover
Hobo Johnson - Mover Awayer
Lil Nas X - Panini - DaBaby Remix
Becky G - Secrets
Dennis Lloyd - Wild West
The Lumineers - Salt And The Sea
Julia Michaels - If You Need Me
push baby - @thebackoftheparty
Silver Sphere - waste my time
Gucci Mane - Richer Than Errybody (feat. YoungBoy Never Broke Again & DaBaby)
NLE Choppa - Camelot
Sueco the Child - dork
Fall Out Boy - Dear Future Self (Hands Up) [feat. Wyclef Jean]
Green Day - Father of All...
Weezer - The End of the Game
Migos - My Family - from "The Addams Family"
88rising - Breathe
bülow - Boys Will Be Boys
SEBASTIAN PAUL - ON SOME HIGH
JPEGMAFIA - Beta Male Strategies
Joyner Lucas - ADHD
grandson - Destroy Me
Miranda Lambert - Fooled Around and Fell in Love (feat. Maren Morris, Elle King, Ashley McBryde, Tenille Townes & Caylee Hammack)
Nina Nesbitt - Black & Blue
Lost Frequencies - Black & Blue
gabriel black - blue skies
The Glorious Sons - Closer To The Sky
SAINT PHNX - Sorry
99 Neighbors - Fuck No (feat. Brasstracks & PhiloSofie)
MadeinTYO - Stop Calling (feat. Key Glock & Tay Money)
Skizzy Mars - Gift and a Curse (feat. Yung Pinch)
ayokay - Sleeping Next To You
Ruel - Free Time
Metronomy - Sex Emoji
Meghan Trainor - Genetics
Caitlyn Smith - Put Me Back Together
Jason Aldean - We Back
Luke Combs - 1, 2 Many
HIXTAPE - No Place Like Hometown (HARDY feat. Keith Urban, Hillary Lindsey)
Your Smith - Man Of Weakness
Cavetown - Telescope
Angel Olsen - Lark
(Sandy) Alex G - In My Arms
Djo - Personal Lies
SOB X RBE - Sensei
Kid Ink - Miami
Travis Thompson - Malice
Robinson - Don't Say
Tujamo - Drop It
Robin Schulz - Rather Be Alone
Breathe Carolina - Too Good
Big Boi - Intentions
POORSTACY - HELP !
Lil West - Ran Outta Time
Berhana - Lucky Strike
Emeli Sandé - Real Life
Wrabel - flying
Lonr. - A.M.
Ghostface Killah - New World
Mozzy - Money Maker
Korn - Finally Free
Liily - Wash
The Goo Goo Dolls - Over You
Half Moon Run - Flesh and Blood
C. Tangana - No Te Debí Besar
Masego - Big Girls
11:11 - Better With Time
Black Coffee - LaLaLa
Armin van Buuren - Mr. Navigator
Gabrielle Aplin - Kintsugi
Hailey Whitters - Heartland
Little Big Town - Over Drinking
UPSAHL - Smile For The Camera
Harry Hudson - Pendulum
Icy Narco - EASE THE PAIN (Legend)
Father - Handful
Myke Towers - Piensan
Joseph - NYE
Claire Ernst - Easy on You
Chiiild - Back to Life
Mark Diamond - Monster
euro - Talk 2 Me Crazy
Rich Rocka - Pesos
Sampa the Great - Leading Us Home