Sigrid - Don't Kill My Vibe
AXWELL Λ INGROSSO - I Love You feat. Kid Ink
Anne-Marie - Ciao Adios
Ed Sheeran - Shape of You (Galantis Remix)
Jidenna - Bambi
​filous - Goodbye feat. Mat Kearney
Gavin James - I Don't Know Why (Danny Avila Remix)
Desiigner - Outlet
Migos - T-Shirt (Spotify Mix)
NERVO - In Your Arms
Aaron Carter - Let Me Let You
Andrew McMahon in the Wilderness - Walking In My Sleep
Adam Friedman - What If
Rag'n'Bone Man - Fade to Nothing
FRND - Substitute
Melanie Pfirrman - I Don't Wanna Love
Kidswaste - Wild feat. Khai
Fetty Wap - Flip Phone
Omarion - Distance
Travis Scott - Yeah Yeah feat. Young Thug
Ryon's World - Grandma's Car feat. Stu da Boi
Milky Chance - Ego
Mike WiLL Made-It, Lil Yachty & Carly Rae Jepsen - It Takes Two
Nick Jonas & Nicki Minaj - Bom Bidi Bom
DJ Snake - Let Me Love You feat. Justin Bieber (R3hab Remix)
Ed Sheeran - Castle on the Hill (Acoustic)
A R I Z O N A - Oceans Away (Mansionair Remix)
MOD SUN - Beautiful Problem feat. gnash & Maty Noyes
Juicy J - Ain't Nothing feat. Wiz Khalifa & Ty Dolla $ign
Smino - Anita
Bridgit Mendler - Temperamental Love feat. Devontée
Young Rising Sons - Carry On
Sia - Helium
Vice - Firetruck feat. Sage The Gemini & TK Kravitz
Bee Gees - Stayin' Alive (Serban Mix)
Corinne Bailey Rae - The Scientist
Lostboycrow - Verona
Moonshine Man - Trouble
Amtrac - Piano Boy
Lupe Fiasco - Jump feat. Gizzle
Two-9 - Used to be Down feat. Key! & Jace
Tep No - Is It Too Much that I'm Asking For
Illenium - Fractures feat. Nevve
Jacob Banks - Unholy War
Cimo Fränkel - Occasional Love
Elliot Moss - Closedloop
Dirty Projectors - Cool Your Heart
Rationale - Vessels
Bush - Mad Love
Marc Scibilia - Summer Clothes
​machineheart - Speak in Tongues
Lindsey Stirling - Hold My Heart feat. ZZ Ward
Charlotte OC - Medicine Man
Zeds Dead - Woman Wine