The Fisk Jubilee Singers - Glory / Stranger (feat. Derek Minor, Shannon Sanders)
Jon Reddick - The Power of Your Name (feat. Matt Redman)
Hillsong Worship - Awake My Soul (With Tasha Cobbs Leonard)
Jonathan Traylor - For The Wild Ones (feat. Adrion Butler)
RICHLIN - Love Like Thunder (feat. Ryan Stevenson)
Da' T.R.U.T.H. - A Greater Story (feat. Sam Collier, Tyra Scott)
SEU Worship - Freedom All Around (feat. David Ryan Cook)
Life.Church Worship - Heaven’s All Around
Jamie Grace - Live About It (lo-fi)
Q Parker - I Need You (feat. John P. Kee, Todd Dulaney, Tank, Jonathan McReynolds, Jacquees, Travis Greene, Ginuwine, Byron Cage, Montell Jordan, Raheem DeVaughn, Jason Nelson, Major, PJ Morton, Musiq Soulchild, Brian Courtney Wilson, Bobby V., Eric Dawkins, JK Howells, Mali Music, Alic Walls, Wingo, RL, Ted Winn, Pleasure P, Sammie, Zacardi Cortez, Ruben Studdard, Case, Marcus Devine, Lyfe Jennings, J. Holiday, Ruff Endz, Darwin Hobbs)
Dray Tate - A Change is Gonna Come (Remix) (feat. Mr. Talkbox, Andre “Dray” Tate, Byron “Mr Talkbox” Chambers, Melvin Williams)
C3LA Music - Move Your Heart + Rest Upon Us
The Worship Initiative - There's a River (feat. Shane & Shane)
Steven Curtis Chapman - That's My Dad
Dan Bremnes - The Way (Acoustic)
Sandra McCracken - I Will Sing
Ben Potter - Comforter II (feat. Laity)
John Tibbs - Make You Feel My Love
Planetshakers - Caught Up In Your Presence (Demo)
Coby James - Born Ready
Riley Clemmons - Over And Over (RUSLAN & Julie Lov Remix)
P. Lo Jetson - Goin' Up
CalledOut Music - Soaring High (Féz remix)
** Christon Gray - Beautiful Dreamer
Marcus Carr - The Gospel
Matt Stinton - There Is No Striving
Community Music - Nothing He Can't Do (feat. Meredith Andrews)
Canyon Hills Worship - Jesus My Treasure (Radio Edit)
Austin & Lindsey Adamec - This Is Where I Belong (Live)
Valley Creek Worship - You Bring the More (Live)
Alive City - Too Young
Mark & Sarah Tillman - Just Jesus
Paul McRae - Humble Beginnings
** John Mark Pantana - I Know Just What You Need (feat. Rebekah Autumn)
Matt Marvane - There is a Redeemer (Single Edit)
** Keith & Kristyn Getty - O Church Arise (feat. Shane & Shane)
Demetrius West - The Return (feat. Earnest Pugh)
Phillips - There Is A God (feat. Craig & Dean)
The Browns - Not Even for a Moment
Jesus Culture - I Need You More Than Anything (Live) (feat. Chris McClarney)
Josh Baldwin - Evidence (Radio Version)
Citizens - Light of Your Grace
Marty - The One With No Discounts (feat. GAWVI, Tommy Royale)
Sir the Baptist - Can't Help Myself (feat. Saint Ashleey, Estelle, MC Lyte, Syleena Johnson, Ann Nesby, The Boys & Girls Club Of America)
NEEDTOBREATHE - Survival (feat. Drew & Ellie Holcomb) (feat. Drew Holcomb & The Neighbors)
** Mack Brock - I Lift My Eyes (Studio Version)
Common Hymnal - Heaven's Here (Live) (feat. Brittney Spencer, Kierre Bjorn)
Natalie Grant - Praise You In This Storm
CAIN - Never Lost (feat. Essential Worship)
Rebecca St. James - Battle Is the Lord's (feat. Brandon Lake)
Elias Dummer - Good
Gable Price and Friends - Communion (feat. Mark Barlow)
NONAH - The River Bows
Jess Ray - Grace & Mercy
Jonny Diaz - Your Love Feels Like Home
Marvin Sapp - Thank You For It All
Nashville Life Music - More Than Words (feat. Alvin Love)
Planetshakers - All I Can Say (Thank You - Demo)
Austin Stone Worship - In The Hands Of Christ My King
Mass Anthem - Stupid Deep / Sinking Deep
** Keith & Kristyn Getty - For The Cause
Jason Upton - Watching Over Me
John Mark Pantana - Made for Jesus (B-Side)
K-Anthony - Already Better (Dale Brown & Truth)
FEARLESS BND - My Only Love
WE ARE ONE - TURNAROUND LOVE (Recomplete)
Philippa Hanna - Oh the Power (feat. Steph Macleod)
Kurtis Hoppie - Vacation
Wes Harris - Not Normal (feat. Rapzilla, Ilish)
Debora Sita - Hold My Heart
Brian Ortize - The Blessing
Ron Poindexter - Soul Is Anchored
Selah - Yet Not I, But Through Christ In Me (Live)
The Sound - Great God Almighty (Radio Edit)
Jason Crabb - Your Help is on the Way
Jekalyn Carr - Changing Your Story
Ryan Stevenson - Through It All
The Worship Initiative - What a Friend We Have in Jesus (feat. Shane & Shane, Hannah Hardin)
Sarah Kroger - Belovedness
REVERE - Way Maker (Live) (feat. Darlene Zschech, William McDowell, Sounds of Unity)
** We Are Messengers - Love (Remix) (feat. Mali Music)
Russ Mohr - Someday Soon (feat. The Kingdom Sessions Voices)
Sajan Nauriyal - The One (feat. Licy-Be)
King Chav - Redemption (feat. Kham, DJ Mykael V)
Vineyard Worship - No Longer Slaves (Live) (feat. Kyle Howard, Lamorax)
Christine D'Clario - Crazy Love (Bilingual Version)
JJ Heller - Miracle
Isla Vista Worship - Captured (Live Session) (feat. Mark Barlow)
John Mark Pantana - Abba (B-Side) (feat. Jonathan Ogden)
Hannah Oliver - Be Ok
Nick & Becky Drake - Speak Your Name (feat. Worship For Everyone)
FRVR FREE - Heart Is Good
Lamar Riddick - Crae (feat. Eli Williams, Rapzilla)
JesusGang - Tik Tok
Jenna Grace May - God You Are Moving
Ascent Project - Miracles (Live) (feat. Matthew McGinley)
Gregory D and Company - My Time
Valley Creek Worship - There Is Always More (Live)
Latice Crawford - Something Something