Niall Horan - Too Much To Ask
Tove Styrke - Mistakes
Lorde - Homemade Dynamite feat. Khalid, Post Malone & SZA
Foo Fighters - Arrows
Noah Kahan - Hurt Somebody
Gucci Mane - Curve feat. The Weeknd
R3HAB & Khrebto - You Could Be
YUNGBLUD - I Love You, Will You Marry Me
The xx - On Hold (Jamie xx Remix)
Sia - Rainbow
Grace VanderWaal - So Much More Than This
Sofi Tukker - Best Friend feat. NERVO, The Knocks & Alisa Ueno
Mr Eazi - Leg Over (Remix) feat. Major Lazer, French Montana & Ty Dolla $ign
AraabMUZIK - Wanted feat. Nevelle Viracocha
Now, Now - Yours
Labrinth - Misbehaving
Tyga - My Way
Huntar - Be My Girl
Ella Vos - Rearrange
Nick Jonas - Find You
Jessie Ware - Alone
The Killers - Some Kind Of Love
U2 & Kygo - You’re The Best Thing About Me
Galantis - Salvage (Up All Night) feat. Poo Bear
Weezer - Beach Boys
Canaan Smith - This Night Back
Jessie James Decker - Almost Over You feat. Randy Houser
Jacob Banks - Unknown (To You)
Courtship. - Tell Me Tell Me
Quinn XCII - One Day At A Time
Alex Aiono - Does It Feel Like Falling feat. Trinidad Cardona & Gryffin
Matt Nash - Run feat. Delayers
Fall Out Boy - The Last Of The Real Ones
The Story So Far - Out of It
Lights - New Fears
Superfruit - How You Feeling?
Joe Moses - On My Bumper  feat. Ty Dolla $ign
MUNA - In My Way
San Holo - I Still See Your Face
Rostam - Thatch Snow
Björk - The Gate
Sara Bareilles - If I Dare
Kevin Gates - Beautiful Scars  feat. PnB Rock
Shoffy - Flags feat. Yuna
Trippie Redd - Bust Down
Marilyn Manson - WE KNOW WHERE YOU FUCKING LIVE
DENM - Bless Your Heart
Andreas Moss - Stuck In My Feelings
Charly Black & Luis Fonsi - Party Animal
Naughty Town - Dancing Machine feat. Laura Mvula
LÉON - I Believe in Us
Hippo Campus - Baseball
Toulouse - Man from Pennsylvania
Hollyn - ¡Hola!