Popcaan & Drake - We Caa Done
NewJeans - OMG
YoungBoy Never Broke Again - Black
Ice Spice - ​In Ha Mood
Yahritza Y Su Esencia - Cambiaste
Old Dominion - Memory Lane
Queen Naija - Let's Talk About It
Tiësto - Lay Low
French Montana - Chit Chat
Alejandro Fernández - Inexperto En Olvidarte
Skrillex - Way Back
Vedo - Do You Mind
Shania Twain - Giddy Up!
Mckenna Grace - Ugly Crier
Steve Aoki - New York ft. mazie
Lola Indigo - CORAZONES ROTOS
SYML - Believer
Joesef - Borderline
Elle King - Tulsa
Rеal Boston Richey - First Time
Russ - PUT YOU ON GAME
India Thieriot - Montagе
Cheat Codes - Bets On Us
Iggy Pop - Comments
Mo Lowda & the Humble - O.O.Y.O.
Seafret - See, I'm Sorry
Richard Fairlie - Think I'm In Love
Sigala & MNEK - Radio
BabyTron - Mr. Hanky
BLOWSOM - Love! love! love!
Gabrielle Aplin - Anyway
Armin van Buuren - Easy To Love
Tyler Hubbard - Me For Me
csurf - one night
2KBABY - Don't Love Me Now (feat. charlieonnafriday)
Zevia - pain's my only home
Dennis Lloyd - Today, Tomorrow
Deorro - You Are Not Alone (feat. Dear Sara)
Lil Darius - Neighborhood Trapstars
R. Missing - Death in a Constellation
Suriel Hess - Wasted
ROZES - Used to Love You
bludnymph - Lights Out
Kamaiyah - Thru The Week
Madison Ryann Ward - GO BACK
RHODES - Good to You
Trash Panda - Doin' Fine Today
Anti-Flag - THE HAZARDOUS
Yung Mal - Gah Damn
Pascal Letoublon - Time After Time
daisy veacock - the things that you tell her
Ryan Mack - Did You Love Me Ever?
Owl City - Kelly Time
Brandon Ratcliff - Where I'm Coming From
White Reaper - Pink Slip
familypet - harder than it looks softer than youd think
yaeow - long way home
Florence Arman - Hello Florence, How Are You?
WYLDE - burnout
Preston Pablo - AY AY AY
Chase Rice - I Hate Cowboys
Tom Rosenthal - World's Greatest Sleeper
Frankie Rose - Anything
RuPaul - Cake & Candy
21 Lil Harold - Out of Time
BiC Fizzle - Check (feat. Big Yavo)
Yotto - Just Over
BUZZ - Nothing is Real
Peter Gabriel - Panopticom - Bright Side Mix
Leony - Somewhere in Between
sad alex - buying a sandwich
JW Francis - Going Home to a Party
The Murder Capital - Return My Head
The Hold Steady - Sideways Skull
Jill Barber - Homemaker
NERIAH - Puppet On A String
Dava - Fool
CJ Fly - HAVE KNOTS
1takejay - Money Got Vert
Clavish - Traumatised
QRTR - again, but colder
Caye - A DOOR
Raissa - I Want Your Sex
Kasey Tyndall - Place for Me
The Lemon Twigs - Corner Of My Eye
Hannah Grace - Silver Lining
Will Epstein - Oyster Bay
Young Rising Sons - Oblivious
SONNY - RISKY
DEBBY FRIDAY - SO HARD TO TELL
wilt - nothing special
Muscadine Bloodline - Teenage Dixie
Shantaia - Know You
Cochren & Co. - Running Home
Davina Michelle - Heartbeat
Somebody's Child - I Need Ya
Kyd the Band - Dark Place
Quiet Houses - Hot and Clumsy
Moglii - Sunliight