
1 Thing -- Amerie
Airplanes -- B.o.B. feat. Hayley Williams
All Of My Heart -- ABC
Ask Me Jon -- The Ocean Blue
Cannonball -- The Breeders
Coming Down -- Todd Johnson
Cry Of The Wild Goose -- Frankie Laine
Dear Prudence -- The Five Stairsteps
Eye of the Hurricane -- David Wilcox
Girl Don't Tell Me -- The Beach Boys
Heading For The Light -- Traveling Wilburys
Hey Nonny Nonny -- The Violent Femmes
I'll Never Be Free -- Tennessee Ernie Ford and Kay Starr
I'm Not Who I Was -- Brandon Heath
I've Got A Feeling -- The Beatles
Johnny B. Rotten - The Monks
Jolene -- Dolly Parton
Just The Way You Are -- Milky feat. Giuditta
My Pal Foot Foot -- The Shaggs
O Superman (For Massenet) -- Laurie Anderson
Ole Buttermilk Sky - Kay Kyser
Papa Loves Mambo -- Perry Como
Pilot Of The Airways -- Charlie Dore
Puttin' On The Ritz -- Fred Astaire
Ring Them Bells -- Sufjan Stevens
Rush -- Big Audio Dynamite II
Senses Working Overtime -- XTC
Tender - Blur
The Only Exception -- Paramore
The Power Of Love -- The Early November
Then the Morning Comes -- Smash Mouth
Toxic - The Chapin Sisters
Vehicle -- The Ides Of March
Violent Blue -- Chagall Guevara
Waterfall -- The Stone Roses
Wrapped in Grey -- XTC
You Are The Generation Who Bought More Shoes And You Get What You Deserve -- Johnny Boy
You're on Fire -- They Might Be Giants2