Blake Roman & The Living Tombstone - "Poison (Official Remix)"
C Stunna & Skrilla - "Curtis Jackson"
Lambotomy - "Forgiver"
4/2
Ayesha Erotica - "Gigabowser" ft. Yvncc
Tafia - "Nice Tab" ft. Meek Mill

4/3
Brezden - "Off White Belt"
Charli XCX - "B2b"
Charli XCX - "Club Classics"
Chrissy Chlapecka - "Verse"
Courtney Bell - "Word II Conway" ft. Conway the Machine
Imagine Dragons - "Eyes Closed"
LUDMILLA & Ryan Castro - "Piña Colada"
Mia Wray - "What If"
Soulja Boy - "Dog Food"
Yaya Bey - "​me and all my niggas"
4/4
Ava Max - "My Oh My"
Beyoncé - "TEXAS HOLD 'EM (PONY UP) REMIX"
Bryce Leatherwood - "The One My Daddy Found"
Empire of the Sun - "Changes"
G-Eazy - "Femme Fatale" ft. Kaliii & Coi Leray
Kehlani - "After Hours"
Mac Critter - "Solid"
Zachary Knowles - "Honeydеw"
4/5
1999 WRITE THE FUTURE & Deb Never - "WhAT yoU WaNT"
2Rarе - "2Humpy Is Back"
41, Kyle Richh & Jenn Carter - "Birthday"
4Fargo & K CAMP - "Miss Your Energy"
Adam Melchor - "​not good for you"
AK - "Wait too Long"
Allison Ponthier - "Lie Detector"
Angus & Julia Stone - "Losing You"
Astrid S - "Oh Emma"
Austin Snell - "Wildfire"
Badger & Natasha Bedingfield - "These Words"
BigWalkDog - "Hold of Me"
Carly Pearce - "my place"
Chappell Roan - "Good Luck, Babe!"
Chikoruss - "USC"
David Guetta & OneRepublic - "I Don't Wanna Wait"
Dillon Carmichael - "I'd Call Grandpa"
Diplo & Riva Starr - "Heaven or Not" ft. Kareen Lomax
Ella Henderson & Natasha Bedingfield - "Alibi (The Other Girl Version)" ft. Rudimental
Good Neighbours - "Keep It Up"
G Perico - "Troll Patrol"
Gyakie - "December"
Haley Sharpe - "Spotless Soul"
Jahmiel - "Solid As A Rock"
Jay Sean & Ikky - "Heartless"
JoJo Siwa - "KARMA"
Jordan Rakei - "Friend or Foe"
JORDY - "NICE THINGS"
Kelsea Ballerini - "Love Me Like You Mean It (Reimagined)"
Lil Wayne & Wheezy - "Bless" ft. Young Thug
Lola Young - "Big Brown Eyes"
Luke Bryan - "Love You, Miss You, Mean It"
Luke Hemmings - "Close My Eyes"
LunchMoney Lewis - "Rain or Shine"
​​maryjo - "Should Be Us"
Matt Citron - "Overdrive"
Matt Kearney - "Sumac"
Nas & DJ Premier - "Define My Name"
Omar Apollo - "Spite"
Onsight Deeda - "Add Me Up"
Petey Martin & Seeb - "Someone's Gonna Love Ya"
Quavo & Destroy Lonely - "Potato Loaded"
RealRichIzzo - "Free Key"
Sasha Alex Sloan - "Glad You Did"
SAYGRACE - "Daydreaming"
Sia - "Incredible" ft. Labrinth
Simi & Tiwa Savage - "Men Are Crazy"
Smith & Thell - "Little Altar Boy"
Tane Runo - "RACES"
Tanerélle - "Better Days"
Tanerélle - "Better Days - A COLORS SHOW"
Tenille Arts - "So Do I"
Tom The Mail Man - "9"
Tones and I - "Down Under"
4/7
Little Big Town - "Take Me Home" ft. Sugarland

4/8
Airospace - "Imagine thinking you know everything but know absolutely nothing" ft. Southside Santana

4/9
​koi - "peppermints"
Larry June - "Imported Couches"
Lil Zay - "Brand New Rollie"
Love Moor & Lekan - "Codependent, Pt. 2"
Maeve De Voe - "Sassy Girl"
Soulja Boy - "Trap Boy"
Zotiyac - "Tha Most"
4/10
Arlo McKinley - "Place to Sleep"
Dave Moffatt – "Right Here Waiting"
Kodak Black - "Stressed Out"
Lil Nas X - "RIGHT THERE"
Mnelia - "Heaven"
Nia Archives - "Cards On The Table"
Tink "Charged Up"
Yung Miami - "CFWM (Can't F*** Wit Me)" ft. Skilla Baby

4/11
D-Block Europe - "KiKi (What Would Drizzy Say?)"
Dua Lipa - "Illusion"
Jonathan Moly - "Shein"
PARTYNEXTDOOR - "L o s e M y M i n d"
Sabrina Carpenter - "Espresso"
Quavo - "Tender"
4/12
Amanda Reifer - "In and Out (Interlude)"
Andra Day - "Chasing"
Armaan Malik & Calum Scott - "Always"
Austin Williams - "Country Just Like Me"
Baby Bugs - "My Pastor"
BBG Steppaa - "Bisexual Glock"
Ben Fuller & Megan Danielle - "If I Got Jesus"
BigXthaPlug, Ro$ama & Yung Hood - "Meet The 6ixers"
Blxckie - "all faxx"
BRELAND - "Praise the Lord (The Road House Edit)"
Casey Baer & Caleb Hearn - "​never have i ever"
Charli XCX - "The von dutch remix with skream and benga" ft. Skream & Benga
Chlöe - "Boy Bye"
Cole Swindell - "Forever To Me"
Corbyn Besson - "Like That" ft. Armani White
Dagny – "Strawberry Dream"
Desiigner - "Drip Check"
Dylan Harrison - "Got Me Tonight"
Ella Henderson – "Alibi (Henri PFR Remix)" ft. Rudimental
Erin Kinsey - "I Ain't Crazy"
Gabbie Hanna - "Everlasting Love"
Galantis, 5 Seconds of Summer & My Pal Al - "Lighter (MY PAL AL Remix)"
G Perico - "She Sexy"
Gus Dapperton - "What You Won’t Do for Love"
Hitkidd & Lil Gotit - "Secluded"
Hunxho - "Closer to Over"
Jimmy Fallon & Meghan Trainor – "Sweet Morning Heat (from the Netflix Film "Unfrosted")"
Jordan Ward - "Player Two - From “Don’t Tell Mom The Babysitter’s Dead”"
Kalan.FrFr - "EVERYBODY"
Keith Urban & Snoop Dogg - "Let It Roll"
Key Glock & Young Dolph - "Let's Go (Remix)"
Koe Wetzel - "9 Lives (Black Cat)"
Kuttem Reese - "How I'm Feeling"
Lizzen & Robin Thicke - "Why (Remix)"
MaKenzie - "Velvet"
midwxst - "FIRE" ft. DC The Don
Monsieur Nov - "Dans son tel"
Morgan Wade - "Time to Love, Time to Kill"
Ndotspinalot - "Ndot"
NLE Choppa - "Slut Me Out 2"
NOTD & Riley Biederer - "Under My Breath"
Olivia O'Brien – "blip"
OneRepublic – "Nobody (from Kaiju No. 8)"
Original God - "MANIC"
Parker McCord - "Long Night" ft. Lucy Loone
Ray Vaughn - "Blasphemy"
Rowan Drake - "Why"
Rowdy Rebel & Fetty Luciano - "Pistons"
Sekou - "​let go of me slowly"
Shaboozey - "A Bar Song (Tipsy)"
Sia - "I Forgive You"
Sugarhill Ddot - "Tweakin"
Surf - "CHAD"
Tafia - "Whoodie Hoo"
Tanner Adell - "Whisky Blues"
Taylor Acorn - "Greener"
Tinashe - "Nasty"
WILLOW – "b i g f e e l i n g s"
Yelawolf - "New Me"
Your Old Droog - "DBZ" ft. Denzel Curry, Method Man, Madlib
Yung Bleu - "Confirmation (Remix)" ft. Lil Wayne
ZAYN - "Alienated"
4/14
Brit Smith - "Karma's a Bitch"
Rick Ross - "Champagne Moments"
4/15
Finesse2Tymes - "Letter to the Devil"
Jamie xx - "Baddy on the Floor" ft. Honey Dijon

4/16
​​Sam Tompkins - "numb"
Yung Bambi - "Texture"
4/17
Bad Omens - "THE DRAIN" ft. HEALTH & Swarm
DJ Snake & Peso Pluma - "TEKA"
Lil Darius - "Rick & Marni"
Lil Nas X - "Lean On My Body"
Fontaines D.C. - "Starburster"
Sadie Jean - "You Don't"
Willow Kayne - "Robot Lovers"
4/18
Headie One & Stormzy - "Cry No More"
PVRIS - "Oil & Water"
Icewear Vezzo - "Cheescake"
4/19
Alfie Templeman - "Hello Lonely"
Ali Gatie - "Drowning"
ASTN - "Soul, Body & Mind"
Baby Jungle - "Freaknik" ft. Rob49
Baby Money - "We Getting Money"
Benedict Cork - "Beauty Queen"
BIG30 -"Double Life"
BIGBABYGUCCI - "Maybach" ft. Alois
Bilmuri - "EMPTYHANDED"
Bradley Simpson - "Cry at the Moon (Acoustic)"
CKay - "Wahala" ft. Olamide
Corey Kent - "Rust"
Danielle Bradbery - "Younger and Wiser"
David Guetta, Themba & Jack Back - "Give Me Something to Hold"
Desiigner - "Big Dawg"
Flo Rida - "Friday"
Florrie - "Kissing In the Cold"
FTO Sett - "Duck No Smoke"
Gloss Up & Jacquees - "Ride Home"
HARDY - "Gin & Juice"
Hey Violet - "Best Imposter"
Jessica Sanchez - "Weekend Love"
Jok’Air - "Dans la Benz"
Joy Oladokun - "Questions, Chaos, and Faith"
KB Mike - "I Think I Love U"
Kygo, Zak Abel & Nile Rodgers - "For Life"
Lily Rayne - "I Wonder"
Logic - "44ever"
Lost Frequencies & David Kushner - "In My Bones"
Lucas Estrada, James TW & SUPER-Hi - "Don't Look Down"
Lucky Daye - "HERicane"
NATURE & Ellie Goulding – "Brightest Blue (Nature Remix)" ft. NATURE
Money Man - "Tangled"
Neoni - "Utopia"
Nicki Minaj - "FTCU (SLEEZE MIX)" ft. Travis Scott, Chris Brown & Sexyy Red
Nolan Taylor - "In The Other Room"
Payroll Giovanni - "Rose Anniversary"
Perrie – "Forget About Us (Extended)"
Phoebe Green - "I Think That I'm Getting Boring"
R3HAB & Jason Derulo - "Animal"
Reyanna Maria - "Wish U Well"
Robert Grace - "Reasons"
Ron Suno & Zeddy Will - "Jungle Fever" ft. J.P.
Rosa Linn & Galantis - "Universe (Galantis Remix)"
Russ - "That's My Girl"
Russ - "Tired"
SadBoi - "Baddies"
Sia - "Fame Won't Love You" ft. Paris Hilton
Skilla Baby - "Free Big Meech"
$UICIDEBOY$ - "Are You Going to See the Rose in the Vase, or the Dust on the Table?"
SYLO - "So Familiar"
Tee Grizzley - "Suffer In Silence"
The Outfield & Diplo - "Your Love (Remix)"
Vacra - "Agent Secret"
VEDO - "Your Love Is All I Need"
Victoria Justice - "RAW"
YAS - "sky walking"
Zac Brown Band - "Pirates & Parrots" ft. Mac McAnally

4/20
J.K. Mac & YoungBoy Never Broke Again - "Swear"
4/21
Fetty Wap - "Cali"
4/22
Li Rye - "JB & Rod"
Quavo - "Over Hoes & Bitches (OHB)" ft. Takeoff

4/23
Brezden - "Leave Me"
4/24
Bonnie McKee - "Jenny's Got A Boyfriend"
Gucci Mane - "TakeDat"
New Kids on the Block - "A Love Like This"
Train - "Long Yellow Dress"
4/25
Aitch - "Famous Girl"
Chance the Rapper - "Buried Alive"
Chenayder & MAVI - "Colors"
Hunter Hayes - "Best Part"
Mabel - "Vitamins"
Mac Critter - "Money On Dial"
Twenty One Pilots - "Backslide"
4/26
1Up Tee - "Accountability Pt. 2"
Aaron Carter - "Recovery"
Apollo Liberace & Tyla Yaweh - "Paradise"
Babyface Ray - "Glory"
Bea and her Business - "Good Things"
Big Yavo - "You Ain't Neva"
Bookish Songs Collective - "Ready to Burn"
Arian Cruz - "I Didn't See This Coming..."
Cash Cobain, Ice Spice & Bay Swag - "Fisherrr (Remix)"
Co Cash - "Thang Thang"
Coi Leray - "Can't Come Back"
Colton Dixon - "Rest of My Life"
Darius Rucker & Jennifer Nettles - "Never Been Over"
Daughtry - "Pieces (Broken Down)"
Elle King - "Baby Daddy’s Weekend"
ERIC NORTH - "Dematerialize"
Foggieraw - "Stay Awhile" feat. Ari Lennox
Galantis - "Dust"
Jack Johnson & Stick Figure - "Home"
James Charles - "Can We Just Be Friends"
Jimbo World - "I'm In Da O Wit It"
JT - "OKAY"
Kane Brown - "Georgia On My Mind"
Kerli - "The Art of Being Alone"
King - "Bumpa" feat. Jason Derulo
​​koi - "overrated"
Lil Bean - "real never die"
Lil Migo - "Pray To God"
Mason Ramsey - "Something You Can Hold"
Nardo Wick - "Back to Back" feat. Future
Normani - "1:59" ft. Gunna
Olly Alexander - "Dizzy (Acoustic)"
Perrie - "Forget About Us (Live)"
Rachel Platten - "Bad Thoughts"
Saba & No I.D. - "head.rap" feat. Jordan Ward, Ogi, Madison McFerrin
Scorey - "Feeling Fine"
Shenseea - "Neva Neva"
Sybyr - "Lied 2 Me"
Tems - "Love Me JeJe"
The Afters - "What Gad Is Gonna Do"
The Chainsmokers - "Friday" feat. Fridayy
Tiera Kennedy - "I Ain’t a Cowgirl"
Topic & A7S - "Out My Head"
Tommy Richman - "MILLION DOLLAR BABY"
Trixie Mattel - "Shadow - Spotify Singles"
Vanessa Williams - "Legs (Keep Dancing)"
YG - "Knocka"
YUNGBLUD - "I Was Made for Lovin' You - from The Fall Guy"
4/27
KA1D - "After Me"
4/28
LG Malique - "7 Years (Remix)"
4/29
gavn! - "Open Arms (Hallelujah)"
4/30
Belhassen Kadim - "Man Like Him"
HANNAH KATANA - "You Make My Screws Come Loose"
TBA
NAV - "Red"1