Young Thug - Anybody feat. Nicki Minaj
G-Eazy - 1942 feat. Yo Gotti & YBN Nahmir
ZAYN - Let Me
Lil Pump - Esskeetit
Bebe Rexha - Ferrari
Louis The Child - Better Not feat. Wafia
Taylor Swift - September (Recorded at The Tracking Room Nashville)
CHVRCHES - Miracle
King Princess - Talia
Bazzi - 3:15
Swae Lee, Slim Jxmmi & Rae Sremmurd - Guatemala
Nicki Minaj - Chun-Li
Kid Cudi - The Rage
Florence + The Machine - Sky Full Of Song
Janelle Mon√°e - Pynk feat. Grimes
Youngr - Drive
Sofi Tukker - That's It (I'm Crazy)
BATE - One I Love feat. Blake Rose & Radio 3000
SATICA - Inner Child
Juice WRLD - All Girls Are The Same
Smokepurpp & Murda Beatz - Pray feat. A$AP Ferg
5 Seconds of Summer - Youngblood
Brandyn Burnette & dwilly - Hands Down feat. Kayo Genesis
Tinashe - Stuck With Me feat. Little Dragon
John Splithoff - Raye
Amy Shark - I Said Hi
Aries - SAYONARA
Sigrid - High Five
Carrie Underwood - Cry Pretty
Taylor Swift - Delicate (Recorded at The Tracking Room Nashville)
The Shires - The Hard Way
50 Cent - Crazy feat. PnB Rock
DJ Megan Ryte - On & On feat. Tory Lanez & HoodCelebrityy
6ix9ine - GOTTI
Jim Jones - Gotta Play the Game feat. YFN Lucci
Princess Nokia - For the Night
The Longshot - Love is for Losers
Nothing,nowhere. - rejecter
Bearson - Get Lost feat. Ashe
REMMI - Desperate
Christopher - Bad
Pentatonix - Perfect
Gavin James - Always
Cash Cash - Finest Hour feat. Abir
Higher Brothers & DJ Snake - Made In China
Marian Hill - Wish You Would
Robotaki - Satisfied feat. City Fidelia & Luigi Fidelia
Carnage - Overtime feat. Sebastian Reynoso & KYLE
Skizzy Mars - Greedy
Royce Da 5'9" - Stay Woke feat. Ashley Sorrell
Highasakite - Out of Order
Ekali & Medasin - Forever feat. Elohim
Alae - Stone Cold
Cole Swindell - Somebody's Been Drinkin'
Lali - 100 Grados feat. A.CHAL
Kideko - Good Thing
DREAMS - Silence
Jackson Penn - Babylon
TOMI - Every Morning I Feel Like Running Away
Ciaran Lavery - Two Days in Savannah
Gang Gang Dance - Lotus
Dean Lewis - Waves (JordanXL Remix)
Dierks Bentley - The Mountain
Chaos Chaos - Pink Politics
Allen Stone - Brown Eyed Lover
Wet - Softens
Asteph - No One Will Smile
Calpurnia - Louie
Couros - Young
AUGUST 08 - Lately
Powers Pleasant - Pull Up feat. Joey Bada$$ & A$AP Ferg
Robert Glasper Experiment - Find You (KAYTRANADA Remix) feat. Iman Omari
Henry Jamison - Real Peach (Recorded at Spotify Studios NYC)
Breaking Benjamin - Torn in Two
La Luz - The Creature
Phora - Come Thru
Morgan Wallen - Happy Hour
Tritonal - Out My Mind (Club Mix) feat. Riley Clemmons
Jenny Hval - Spells
Mavi Phoenix - Yellow