Shawn Mendes - Lost In Japan
Diplo - Color Blind
BLVK JVCK - Love Me Still feat. Jessie Reyez
Belly - 4 Days feat. YG
No Jumper - Hard feat. Tay-K and BlocBoy JB
David Guetta & Sia - Flames
Bazzi - Honest
Panic! At The Disco - Say Amen (Saturday Night)
Kasbo - Roots feat. Amanda Fondell
Snow Patrol - Don't Give In
Charlotte Lawrence, Nina Nesbitt & Sasha Sloan - Psychopath
Keith Urban - Coming Home feat. Julia Michaels
Thirty Seconds To Mars - One Track Mind feat. A$AP Rocky
Marian Hill - Differently
Vancouver Sleep Clinic - In the End
Eminem - Nowhere Fast (Extended Version) feat. Kehlani
Lil Skies - Creeping feat. Rich the Kid
Hillsong United - So Will I (100 Billion X) (Bodytalkr Remix)
AJR - Burn the House Down
KYLE - Playinwitme feat. Kehlani
BlocBoy JB - Rover 2.0 feat. 21 Savage
N.E.R.D & Rihanna - Lemon (Drake Remix)
Kacey Musgraves - High Horse
Matoma - Lonely feat. MAX
Jack White - Ice Station Zebra
Sarah Reeves - Something About You
Timeflies - Be Easy
NoMBe - Milk & Coffee
San Holo - Right Here, Right Now feat. Taska Black
Trouble & Mike WiLL Made-It - Come Thru feat. The Weeknd
Diplo - Wish feat. Trippie Redd
Alec King - Keep It Real
Vory - 9.22
Chloe x Halle - Happy Without Me feat. Joey Bada$$
070 Shake - Mirrors
Autograf - Dead Soon feat. Lils & Bonsai Mammal
E^ST - Blowjob
Ben Platt & Lin-Manuel Miranda - Found / Tonight
Two Door Cinema Club - New Houses
SHY Martin - Bad in Common
Steve Angello - Nothing Scares Me Anymore feat. Sam Martin
Nightly - Holding On
Kodaline - Follow Your Fire
Jack & Jack - I Don't Know
Berhana - Whole Wide World
Goody Grace - Two Shots feat. gnash
Paty Can'tú - Miento feat. Jesse Baez
Ryan Hurd - Diamonds or Twine
Underoath - Rapture
Grandson - thoughts & prayers
NONONO - Friends
Mr. Popular - Price Is Right
Still Woozy - Lucy feat. ODIE
NVDES - Louì
Golden Features - Falling Out
Sheck Wes - Do That
Yung Bans - Don’t Milly Rock feat. Rejjie Snow
The Shadowboxers - Timezone
Jason Aldean - Gettin' Warmed Up
Devin Dawson - Whiskey (Recorded at Spotify Studios NYC)
Snail Mail - Pristine
Joan - i loved you first
RuthAnne - The Vow
ELEL - Early in the Morning
Steve Aoki & Quintino - Mayhem
Let's Eat Grandma - Falling Into Me
Mishegas - Episodes
George Ezra - Shotgun
Burak Yeter - Crash
CVIRO & GXNXVS - Lady
Ernest K., Case Arnold & Bryant Taylorr - I Love My City
Spencer Ludwig - Just Wanna Dance
Grizfolk - Endless Summer
FINNEAS - Heaven
Toni Braxton - My Heart feat. Colbie Caillat
NEEDTOBREATHE - Bridges Burn
Marc Scibilia - Over You
Thandi Phoenix - My Way
Ray LaMontagne - Such A Simple Thing
Hiss Golden Messenger - Passing Clouds1