Kygo & Miguel - Remind Me to Forget
Halsey - Alone feat. Big Sean & Stefflon Don
Charlie Puth - Done For Me feat. Kehlani
The Chainsmokers - Everybody Hates Me
Sabrina Carpenter & Jonas Blue - Alien
Kasbo - Over You feat. Frida Sundemo
Hayley Kiyoko - Let It Be
Gundelach - Iron
N.E.R.D & Rihanna - Lemon (Drake Remix)
Whethan - Be Like You feat. Broods
Sasha Sloan - Hurt
RL Grime - I Wanna Know feat. Daya
XXXTENTACION - NUMB
Dana Vaughns - Underneath
Mat Kearney & RAC - Memorized
Rich The Kid - Early Morning Trappin feat. Trippie Redd
Snakehips - Cruzin' feat. St Rules
Banx & Ranx & Ella Eyre - Answerphone feat. Yxng Bane
NOTD - I Wanna Know feat. Bea Miller
Echosmith - Over My Head
Syn Cole - Who You Are feat. MIO
Kaskade - Cold as Stone feat. Charlotte Lawrence
NAV - Freshman List
Cheat Codes & Danny Quest - NSFW
The Driver Era - Preacher Man
Troye Sivan - Strawberries & Cigarettes
ORKID - Wasted
Gang of Youths - The Heart Is a Muscle
Q-Tip - Don't Go Breaking My Heart
Tyron Hapi & Liam Ferrari - I Like The Way
PRETTYMUCH - Healthy
Rhys - No Vacancy
Famous Dex - Japan
Duke Dumont & Ebenezer - Inhale
DJ Envy & Derez Deshon- Hardaway (Remix) feat. Yo Gotti & 2 Chainz
Sorcha Richardson - Can't We Pretend
Johnny Rain - Peach
Leon Bridges - Bet Ain't Worth the Hand
Kota Banks - Zoom
Sigrid - Raw
Cairo Gold - Torture
Jason Aldean - Rearview Town
Anna Lunoe - Blaze of Glory
Sway Clarke - Drugs
Kevin George - Over
Chris Stapleton - I Want Love
Lxandra - Dig Deep
Saweetie - B.A.N
The Fratellis - Sugartown
Chris McClenney - sidetoside
Shaggy - Why feat. Massari
Jayce - In the Car feat. JP Clark
Prince Royce - El Clavo
Robotaki - Butterscotch feat. Jamie Fine & falcxne
Kidnap - Aurora
Jordan Davis - Going 'Round
George Ezra - Saviour feat. First Aid Kit
Tchami & Malaa - Kurupt
The Decemberists - We All Die Young
SOHN - Nil
Yungen - Mind On It feat. Jess Glynne
Sophia Black - Real Shit feat. KYLE
The Voidz - ALieNNatioN
YoungBoy Never Broke Again - Right Or Wrong feat. Future
Yxng Bane - Vroom
Fickle Friends - Rotation
Courtney Barnett - Need A Little Time
Nicole Millar - Gimme A Break
Lovele$$ - No Regrets feat. Lil Yachty
Srsly - Out Here feat. G.L.A.M
Lil Xan - Betrayed (Remix) feat. Yo Gotti & Rich The Kid
Tee Grizzley - Don't Even Trip feat. Moneybagg Yo
BIGBANG - FLOWER ROAD
Amen Dunes - Believe
Yo La Tengo - Shades of Blue
Trouble & Mike WiLL Made-It - Real Is Rare (Edgewood) / The Woods
Melii - Icey
Pearl Jam - Can't Deny Me
Portugal. The Man - Feel It Still ("Weird Al" Yankovic Remix)
(⣎⡇ꉺლ༽இ•̛)ྀ◞ ༎ຶ ༽ৣৢ؞ৢ؞ؖ ꉺლ -  ̸ ̡ ҉ ҉.·๑ඕั ҉ ̸ ̡ ҉ ҉.·๑ඕั ҉ ̸ ̡ ҉ ҉.·๑ඕั ҉ ̸ ̡ ҉ ҉.·๑ඕั ҉ ̸ ̡ ҉ ҉.·๑ඕั ҉ ̸ ̡ ҉ ҉.·๑ඕั ҉ ̸ ̡ ҉ ҉.·๑ඕั ҉
Dorothy - Freedom