Marshmello & Anne-Marie - FRIENDS
BlocBoy JB - Look Alive feat. Drake
James Bay - Wild Love
Calvin Harris - Nuh Ready Nuh Ready feat. PARTYNEXTDOOR
Whethan & Dua Lipa - High
Khalid & Swae Lee - The Ways
R3HAB & Lia Marie Johnson - The Wave
Blue Americans - Apparition
Dashboard Confessional - Crooked Shadows
Rae Sremmurd - T'd Up
Felix Jaehn - Cool feat. Marc E. Bassy, Gucci Mane
2 Chainz - PROUD feat. YG & Offset
Noah Cyrus - We Are... feat. MÃ˜
Mallrat - UFO feat. Allday
Smokepurpp - Big Bucks
More Giraffes - Basement
Towkio - 2 Da Moon feat. Teddy Jackson & Grace Weber
Prelow - Good People Do Bad Things
Rich The Kid - Plug Walk
AUGUST 08 - Funeral
Marian Hill - Subtle Thing
Brent Faiyaz - Make Luv
YoungBoy Never Broke Again - Love Is Poison
Anthony Russo - 2:AM
Chelsea Cutler - You're Not Missing Me
Huntar - Beautiful
The Wombats - Black Flamingo
The Aces - Volcanic Love
Brian Fallon - Come Wander With Me
Au/Ra - Panic Room
Branko - MPTS feat. PEDRO
Albin Lee Meldau - The Weight is Gone
AREA21 - Happy
COIN - Growing Pains
Lauren Ruth Ward - Sheet Stains
Chelsea Lankes - Easy
A-Trak, Falcons & Young Thug - Ride For Me feat. 24hrs
Comethazine - Fuck Me in My Jag
Carly Paige - Drive Slow
Franz Ferdinand - Paper Cages
Sonder - One Night Only
Laura Misch - Lagoon
KOPPS - Hott feat. Joywave
St. Vincent - Los Ageless (Recorded At Spotify Studios NYC)
A Perfect Circle - TalkTalk
Barns Courtney - Sinners
Sizzy Rocket - Mulholland
Jesse Saint John - MOVE
Rozzi - Never Over You
Anna Mae - Single-Minded
Andreas Moss & Melanie Pfirrman - Lonely
Snny - Let's Not Pretend
The Wonder Years - Sister Cities
Flosstradamus - 2 MUCH feat. 24hrs
Wild Child - Follow Me
Shakey Graves - Kids These Days
Russell Dickerson - Man in the Mirror (Recorded at Sound Stage Studios Nashville)
FINNEAS - Break My Heart Again
Rainsford - Japanese Time
Coasts - You Could Have Been the One
Danny L Harle - Blue Angel feat. Clairo
DOROTHY - Who Do You Love
Black Atlass - My Life
Grandson - Overdose
Koda - White Dove
MGMT - Me and Michael
Iron & Wine - About a Bruise (Recorded at Spotify Studios NYC)
Girlpool - Picturesong
Car Seat Headrest - My Boy (Twin Fantasy)
FOURS - Sweet Reality
The Presets - 14U+14ME
Youngblood Hawke - Trust
Her - Neighborhood
Steve Moakler - Born Ready
Marc Scibilia - Rather Be