XXXTENTACION - SAD!
Nicky Jam & J Balvin - X
Cheat Codes - Put Me Back Together (feat. Kiiara)
Diplo - Worry No More (feat. Lil Yachty & Santigold)
MNEK - Tongue
Swae Lee - Hurt To Look (feat. Rae Sremmurd)
Rae Sremmurd - Powerglide (feat. Juicy J)
ALMA - Good Vibes
Karol G - Pineapple
Meghan Trainor - No Excuses
CHVRCHES - My Enemy
Shallou & Kasbo - Find
Fickle Friends - Wake Me Up
EBEN - LAMBO
Young Fathers - Toy
XXXTENTACION - changes
Soccer Mommy - Last Girl
G Flip - About You
The Blaze - HEAVEN
Mt. Joy - I'm Your Wreck
Tory Lanez - Hypnotized
Nothing,nowhere. - hammer
Superorganism - Night Time
Moss Kena - Problems
Pronoun - Run
Belle Mt - Made to Find You
Sonny Digital - I Got (feat. Lil Xan and $teven Cannon)
Gucci Mane - Solitaire (feat. Migos & Lil Yachty)
Nessly - Not My Lover
Moss Kena - You Don't Know
The Neighbourhood - Nervous
Carlos Vara - Numb
Shoffy - pushin
Northern Faces - Firecracker
Amber Mark - Love Me Right
LUME - Skin
Young Rising Sons - Whiskey
Timeflies - What's My Name?
Ryan Kinder - Leap of Faith
Now, Now - AZ
Natalie Prass - Short Court Style
TV Noise x Drew Love - Run
Messiah - Pum Pum (feat. Kap G & Play-N-Skillz)
Saba - Busy
Slim Jxmmi - Brxnks Truck (feat. Rae Sremmurd)
Jhene Aiko - Keep Ya Head Up (Spotify Singles)
What So Not - Beautiful
Jack River - Ballroom
JOY. - Fake It
SG Lewis - Coming Up
Chris Brown & Joyner Lucas - Stranger Things
Miriam Bryant - Black Car
Maths Time Joy - Going Nowhere
Molly Moore - Tough Love
Yo La Tengo - For You Too
Smokepurpp & Murda Beatz - 123
Flight Facilities - Need You
Quinn XCII & Kailee Morgue - What The Hell Happened To Us
BOBI ANDONOV - Smoke
Mikky Ekko - Moment
Moby - This Wild Darkness
Funky Craig - Where the Drums At
Frankie Simone - War Paint
Flo Rida - Dancer
Madge - Fight or Flight Club
Coast Modern - Electric Feel
Richy Samo - Let It Off üêö
Everette - Slow Roll
George FitzGerald & Bonobo - Outgrown
Andrew W.K. - Total Freedom
Hillsong Worship - Who You Say I Am
Tom Misch - It Runs Through Me
Little Dragon - Best Friends