Janelle Monáe - Make Me Feel
5 Seconds of Summer - Want You Back
Logic - 44 More
RAYE, Mabel & Stefflon Don - Cigarette
King Princess - 1950
Bazzi - Gone
Imagine Dragons - Next To Me
A$AP Rocky, Gucci Mane, 21 Savage - Cocky feat. London On Da Track
Dillon Francis - We The Funk feat. Fuego
Good Gas - How I Feel feat. 2 Chainz, A$AP Ferg & FKi 1st
Bea Miller - motherlove
Kacey Musgraves - Space Cowboy
NoMBe - Drama feat. Big Data
David Guetta, Martin Garrix & Brooks - Like I Do
Nessly - Make It Right feat. Joji
Robinson - Nothing to Regret
Hillsong Young & Free - P E A C E
Ricky Martin - Fiebre feat. Wisin & Yandel
Alex Lustig - In the End feat. Akacia
Bishop Briggs - White Flag
DJ Snake - Magenta Riddim
Towkio - Morning View feat. SZA
6ix9ine - RONDO feat. Tory Lanez & Young Thug
Seeb & Skip Marley - Cruel World (Wolfgang Wee & Markus Neby Remix)
DENM - Good Vibes feat. gnash
Emma McGrath - Love You Better
Superorganism - Reflections On The Screen
Blac Youngsta - Heavy Camp feat. Travis Scott
Yuno - No Going Back
JOHN.k - Best of Me
Cautious Clay - Blood Type
24hrs - Lie Detector feat. Lil Pump
Riz La Vie - Napkins
Lewis Capaldi - Rush feat. Jessie Reyez
Pale Waves - Heavenly
Vancouver Sleep Clinic - Ayahuasca
Hembree - Continents
KLP - Carried Away feat. Milwaukee Banks
George Taylor - Stay Warm
Clara Mae - I Forgot
BoA - ONE SHOT, TWO SHOT
The Night Game - Bad Girls Don't Cry
Foster The People - Sit Next to Me (Stereotypes Remix)
Vance Joy - Take Your Time
Charlotte Day Wilson - Funeral
Sophie Simmons - Black Mirror
GASHI - 1134
Ski Mask The Slump God - DoIHaveTheSause?
Fall Out Boy - I Wanna Dance With Somebody (Who Loves Me) (Recorded at Spotify Studios NYC)
Kim Petras - Human (Recorded at Spotify Studios NYC)
Preme - No Defeat
Harry Hudson - No Good
Father John Misty - Mr. Tillman
Tritonal - Out My Mind feat. Riley Clemmons
Pentatonix - Havana
Timeflies - Are You Down
Yellow Claw - Loudest MF feat. Bok Nero
Janelle Monáe - Django Jane
Yung Fume - Something Else feat. Young Nudy
Robert DeLong - Favorite Color Is Blue feat. K.Flay
Lil Boom & Dbangz - Kimono
VanJess - Easy feat. Berhana & Leikeli47
Twin Shadow - Saturdays feat. HAIM
Natalie Prass - Short Court Style
The Aces - Lovin' is Bible
Sigala & Paloma Faith - Lullaby
Jake Miller - The Girl That's Underneath feat. Jabbar Hakeem
Major Murphy - One Day
Cole Swindell - Break Up in the End
Darlingside - Singularity
Holly Miranda - When Your Lonely Heart Breaks
Zilo - Keep Up Wimmi
Ramz - Power
Louis Berry - Stumbling
Svrcina - Whispers
Max Frost - Good Morning
Confetti - People Suck
Dispatch - Dear Congress, (17)