Charlie Puth - The Way I Am
Travis Scott - Watch (feat. Lil Uzi Vert & Kanye West)
Rae Sremmurd - Buckets (feat. Future)
LSD - Genius
Marshmello - You Can Cry
Julia Michaels - Jump (featuring Trippie Redd)
BlocBoy JB - Nun Of Dat (feat. Lil Pump)
Jess Glynne - I'll Be There
Chantel Jeffries - Wait (Featuring Offset & Vory)
Joyner Lucas - I Don't Die
Enrique Iglesias - MOVE TO MIAMI
Jessie Reyez - Body Count
Preme - Jackie Chan
J Balvin - Positivo
Mat Kearney - Changes
Christina Aguilera - Accelerate
Guns N' Roses - Shadow Of Your Love
Cheat Codes - Balenciaga
Leon Bridges - Forgive You
Swae Lee - Touchscreen Navigation
Juice WRLD - Lucid Dreams
Cuco - Dontmakemefallinlove
Jeremy Zucker - wildfire
Luke Combs - Beautiful Crazy
Tom Tripp - Loving You More
Future - No Shame
Matt Hunter - Dicen
Florence + The Machine - Hunger
Saweetie - ICY GRL (Bae Mix) (feat. Kehlani)
Ashe - Choirs
Snow Tha Product - Myself (feat. DRAM)
Cuco - Lucy
Dan + Shay - All To Myself
Troye Sivan - Bloom
Marc E. Bassy - Main Chick
RAYE - Confidence
Dagny - That Feeling When
Alice In Chains - The One You Know
Slim Jxmmi- Anti-Social Smokers Club (feat. ZoÃ« Kravitz)
Gallant - Doesn't Matter
YUNGBLUD - 21st Century Liability
Moneybagg Yo - FEBRUARY (feat. Jeezy)
morgxn - me without you
NIKI - Vintage
A$AP Ferg - Moon River
Nick Talos - Hey Gorgeous
6 Dogs - Drink Up (feat. Yung Bans)
Jennifer Hudson - I'll Fight
Thutmose - Run Wild
Denny White - Alone with You
Desiigner - Priice Tag
Ernest K. - Twisted
R3HAB - Hold on Tight
Jean Deaux - Energy
Royce Da 5'9" - Caterpillar (feat. Eminem & King Green)
Donna Missal - Driving
Parker Millsap - Fine Line
Emotional Oranges - Motion
Now, Now - MJ
Aquilo - Who Are You
Felix Snow - Reminded Buffalo (feat. TYSM)
Natalie Prass - Lost
Johnny Yukon - Miscommunication
Jimmy Eat World - Love Never
TOMI - Coming Around
Belly - Mine
ORKID - So Rude
BANNERS - Let Go
Shakey Graves - Cops And Robbers
Duskus - Take Me Home
Trampled by Turtles - Annihilate
Afrojack - One More Day
pronoun - run
Emma Blackery - Agenda
Violet Days - Just a Little
Amber Mark - Love Is Stronger Than Pride
Johnnyswim - Goodbye Road (feat. Penny and Sparrow)
Slow Hollows - Lessons For Later
Brandyn Burnette - Run
Felix Cartal - Wherever
LEEDS - Your Day Will Come
Tove Styrke - Sway
GRAACE - Kissing Boys