Diamonds - Sam Smith
Me Gusta (with Cardi B & Myke Towers) - Anitta
Mood Swings (feat. Lil Tjay & Summer Walker) - Remix - Pop Smoke
Welcome Back (feat. Alessia Cara) - Ali Gatie
Me x 7 (feat. Tierra Whack) - Alicia Keys
Gates to the Sun (POLLEN Singles) - SahBabii
Said Sum (feat. City Girls & DaBaby) - Remix - Moneybagg Yo
Dolly (with Lil Uzi Vert) - Lil Tecca
Naked - Ava Max
Agreeable - Cautious Clay
hooligan - Baby Keem
Dead Man Walking - Brent Faiyaz
Money Mouf - Tyga
One Too Many - Keith Urban
cowboy in LA - LANY
Bluebird - Gus Dapperton
NOW - Olivia O'Brien
Hot Stuff - Kygo
12 Problems - Rapsody
Lik–µ That (feat. Jeremih & Ty Dolla $ign) - Shy Glizzy
Own It - Rico Nasty
feel away (f–µat. James Blake & Mount Kimbie) - slowthai
Waves - Fiji Blue
Is It Just Me? - Sasha Sloan
god save me, but don't drown me out - YUNGBLUD
ChopBloc Pt. 3 (feat. NLE Choppa) - BlocBoy JB
Damn - Baby Rose
Ready For You (feat. Celeste) - Black Coffee
Blueberry Eyes (feat. SUGA of BTS) - MAX
the author - Luz
Without You - Luke Combs
Long Violent History - Tyler Childers
No Stress - WizKid
[WhoWho - WizTheMc] üêö
Mrs. Whoever - Saba
Victoria - Lunay
YUUUU - Busta Rhymes
Gas Money - Yung Gravy
Super Bad Mantra - JAWNY
Freefall (feat. Oliver Tree) - Whethan
What Love Is - Tom Gregory
Falling - Phil Good
Passport - Masego
Narco - Lil Loaded
Sinners Prayer - Toosii
cat out the bag - contradash
Talk Shit - Savannah Sgro
Back To My Bed - Elderbrook
Too Many Nights - 220 KID
Honest - rei brown
miss andry - flowerkid
Somebody I'm Proud Of - Sarah Barrios
Homesick - Joseph Black
[Oakland Nights - Kamaiyah] üêö
All White - Young Nudy
Perfecta - Luis Fonsi
Amigo - Lous and The Yakuza
Splinter (with salem ilese) - MYRNE
Beautiful Superstar - A. G. Cook
Free - SAULT
Keep Yourself Alive - Yellow Days
Broken Dreams, Inc. - Rise Against
Take Care In Your Dreaming (feat. Denzel Curry, Tricky & Sampa The Great) - The Avalanches
Lost It - Cochise
[STCU (with Juicy J) - THEY.]()
Back in Time (feat. Public Library Commute) - Healy
good things take time - Christian French
Crocodile Tears (feat. Jens Hult) - BUNT.
It's Ok If You Forget Me - Astrid S
Carry Your Heart - Evie Irie
The Word - Alec Wigdahl
Sedona - Sir Chloe
[if you got a problem - Joy Oladokun]()

Stranger - Jacob Banks
MAD - 2KBABY
Wait A Minute - Smoove'L
HMU - Sevyn Streeter
Sharkbait - Teddy Geiger
You Are the Traffic - COIN
Whenever You Call - ARASHI
[War For Love - Bright Lights] üêö
Enchule - Rauw Alejandro
Swimming (feat. Trippie Redd) - IV
[Mismatch (The Remix) feat. Young Thug - Bino Rideaux]()

GLIMPSE ft. Freddie Gibbs - JAHMED
Left Lonely - Hotboii
Sum Mo (feat. 42 Dugg) - Trapboy Freddy
Grouptext - Lido
High Tide, Low Tide - Parson James
Soldiers - Rachel Platten
Passive Aggressive - Charlotte Cardin
GETTING GOOD - Liza Owen
[Alone - Rajiv Dhall]()
Material Boy - Sir Sly
Time Will Tell - Marlon Craft
BookBag 2.0 - BigKayBeezy
R.I.P. - Lil Poppa
[FNY - Barkley]()

High & Dry - G. V. Prakash
Someone Else - Emily Vu
Gone Too Soon - Andrew Jannakos