Alec Benjamin - Must Have Been The Wind
Alesso - Sad Song (feat. TINI)
DJ Snake - Loco Contigo (with J. Balvin & Tyga)
Bazzi - Focus (feat. 21 Savage)
Lewis Capaldi - when the party's over - Recorded at Spotify Studios NYC
Dreamville - Down Bad (feat. JID, Bas, J. Cole, EARTHGANG & Young Nudy)
Marshmello - Rescue Me
Joji - Sanctuary
Chris Brown - No Guidance (feat. Drake)
BTS - A Brand New Day (BTS World Original Soundtrack) [Pt. 2]
GoldLink - Days Like This (feat. Khalid)
Flume - Let You Know
BANKS - Look What You’re Doing To Me
Madonna - Crazy
Gucci Mane - Backwards (feat. Meek Mill)
Little Mix - Bounce Back
COIN - Crash My Car
Dermot Kennedy - Outnumbered
Bastille - Another Place
Matoma - Bruised Not Broken (feat. MNEK & Kiana Ledé)
Dreamville - Got Me (feat. Ari Lennox, Omen, Ty Dolla $ign & Dreezy)
Free Nationals - Time
Midland - Put The Hurt On Me
Kelsea Ballerini - Better Luck Next Time
X Ambassadors - CONFIDENCE (feat. K.Flay)
Julian Lamadrid - Mess
Burna Boy - Anybody
Francis and the Lights - Do u Need Love?
Phangs - Powerline
Silver Sphere - sucks 4 u
Crumb - Jinx
Anna Of The North - Thank Me Later
Tycho - Japan
half•alive - RUNAWAY
King Princess - Useless Phrases
Ali Gatie - It's You
Kevin George - Switch Up
Lil Keed - Rockstar (feat. NAV)
The LaFontaines - Body
Noel Gallagher's High Flying Birds - Sail On
Hayden James - Favours
Kaskade - With You
Galantis - We Can Get High
Monsta X - WHO DO U LOVE?
Baby Keem - INVENTED IT
Vanic - Somedays
Mariah - Perreito
Kamaiyah - Windows (feat. Quavo & Tyga)
93PUNX - Camp America
Social House - Haunt You
Simple Creatures - Special
BUNT. - Sure Don’t Miss You (feat. The Dip)
Hunter Hayes - One Good Reason
San Holo - Lost Lately
Yung Pinch - Perfect
Bruce Springsteen - Western Stars
FINNEAS - Angel
Noah Kahan - Cynic
Mason Ramsey - Twang
Blake Rose - Lady
Alex Ebert - Gold
Jozzy - I'm Gone
Common - HER Love (Feat. Daniel Caesar)
KILLY - Evil Eye
Wale - Gemini (2 Sides)
Teddy Fontana - Tidal Wave
Anthony Russo - More Than You Know
Kim Petras - Personal Hell
More Giraffes - Playground
Gallant - Sharpest Edges
Goth Babe - Imaginationcy
Freddie Gibbs - Giannis (feat. Anderson .Paak)
Luh Kel - BRB
BlocBoy JB - Hooray
Blueface - Daddy (feat. Rich The Kid)
Craig Xen - RUN IT BACK!
Icy Narco - Hypocrites
Drax Project - All This Time
Eryn Allen Kane - With You
Stephen Puth - Look Away
Black Grapefruit - 0122
Trouble - She A Winner (feat. City Girls)
PopLord - Call Me Daddy (feat. Lil Baby)
Marc E. Bassy - Save Me
Zhavia Ward - All I Am (feat. Skip Marley)
10k.Caash - SwajjurKicks (feat. Lil Yachty)
The Raconteurs - Bored and Razed
Octavian - Feel It (feat. Theophilus London)
Rob $tone - One More Drank
Anna Lunoe - Right Party
Christian Leave - Milksop
Milos - Expectations
Augustine - Wishful Thinking
BENEE - Want Me Back
Tritonal - Quit U
Michael Brun - Akwaaba Ayiti
Magic City Hippies - Modern Animal