MC Kevin o Chris - Ela É do Tipo (feat. Drake) - Remix
Frank Ocean - In My Room
The Chainsmokers - Push My Luck
Tory Lanez - Jerry Sprunger (with T-Pain)
Doja Cat - Cyber Sex
ROSALÍA - A Palé
Luke Combs - Does To Me (feat. Eric Church)
Ali Gatie - How Things Used to Be
iann dior - Darkside
Panic! At The Disco - Into the Unknown - From "Frozen 2"
Ozzy Osbourne - Under the Graveyard
Omar Apollo - Hit Me Up
Lil Mosey - Live This Wild
bbno$ - on god
Coldplay - Everyday Life
Johnny Utah - 4Tounce
Meghan Trainor - Workin' On It
Louis The Child - Free (with Drew Love)
Lil Baby - Woah
Ozuna - Hasta Que Salga el Sol
SHY Martin - Make Us Never Happen
Kelsea Ballerini - club
Anthony Russo - Thinkin Bout You
Beck - Dark Places
Tom Walker - Be Myself
Bishop Briggs - CAN YOU HEAR ME NOW?
Bring Me The Horizon - Ludens
Mura Masa - Deal Wiv It
Julian Lamadrid - Moment
SONIA - I Don't Know
Anson Seabra - Last Time
Jordan Davis - Cool Anymore
Zara Larsson - Invisible - from the Netflix Film Klaus
Jacquees - Risk It All (feat. Tory Lanez)
KAROL G - Tusa
Jason Derulo - F It Up
88GLAM - Bankroll (feat. Lil Keed)
Stunna 4 Vegas - Up The Smoke (with Offset)
Labrinth - Like A Movie
AWOLNATION - The Best
Noah Cunane - Medicine
The Script - Run Through Walls
HRVY - Million Ways
Pablo Alborán - Tabú
CamelPhat - Rabbit Hole
IZA - Evapora
Thutmose - Love in the Morning
Iggy Azalea - Lola
Chloe Lilac - High School
Greyson Chance - Boots
Two Feet - BBY
Skip Marley - Slow Down (with H.E.R.)
Grandma - Stomp and Grind (feat. Rico Nasty)
Grey - Grey Area
AJ Mitchell - Say It Again
WENS - Rich & Famous
Emotional Oranges - West Coast Love
Tinashe - Touch & Go
Dave East - Night Shift
J Hus - Must Be
Rexx Life Raj - Somewhere In Paris
Lauren Sanderson - Upset
Best Coast - For The First Time
Tennis - Runner
Caro - rock bottom
Audien - Over It
Deante' Hitchcock - How TF
Yungeen Ace - Step Harder
Deemic - Late Night
Mithoon - Intezaar
Allie X - Regulars
Carson Lueders - Lonely
NOLAN - Killer on the Low
Sevyn Streeter - Whatchusay
Free Nationals - Shibuya
Delly - Quarter Water
REASON - Same Ol Shit
DREAMERS - Desensitize
Nick Leng - Lonely Shade of Blue
Easy Life - Sangria
Yoshi Flower - Martyr
Shaylen - Sprite
Allen Stone - Miscommunicate
Love Mansuy - Count On You
Blac Youngsta - So What
Rayven Justice - Straight Up
Devon Gilfillian - Unchained
Morgan Evans - Diamonds
Salem - 757
Fantasia - PTSD (feat. Tank & The Bonfyre)
Godfather of Harlem - Wolves Are Out Tonight (feat. Snoh Aalegra)
Griselda - Chef Dreds
Leslie Odom Jr. - Cold
Joe Trufant - Lamb