Mike Posner - Move On
ROZES - Halfway There
benny blanco - I Found You / Nilda’s Story (with Calvin Harris & Miguel)
Lost Kings - Don't Kill My High
Bring Me The Horizon - medicine
D'Angelo - Unshaken
Rhys Lewis - Better Than Today
3LAU - Would You Understand (feat. Carly Paige)
Ncredible Gang - NoBody Else (feat. Nick Cannon, Ty Dolla $ign & Jacquees)
Bear Hands - Blue Lips (feat. Ursula Rose)
James Hersey - My People
Jada - Lonely
Chris Young - Raised on Country
Backstreet Boys - No Place
Dermot Kennedy - For Island Fires and Family
MISSIO - Rad Drugz
Tape Machines feat Vicki Vox - Sweat On Me
The Regrettes - Don't Stop Me Now
Lil Xan - Watch Me Fall
Chris Brown - Undecided
Duki - LeBron
Cards & Sita - Shouldn't Be Sorry
Paul McCartney - Get Enough
General Crush - Who Is That
Max Jury - LA Rain (Demo)
Mark Diamond - Steady
DJ Mayson - Not Like Them
Sub Urban - Cradles
Lizzo - Juice
Abhi The Nomad - FLUSH
Christina Perri - a thousand years (lullaby)
Frances Cone - Late Riser
Wild Youth - Making Me Dance
Fleur East - Favourite Thing
Grizfolk - Spoonful
Sody - Whole - demo
Emily Brimlow - Hope
Dan Talevski - Home Alone
Balthazar - I’m Never Gonna Let You Down Again
Lofey - Watch Me Do It Remix
Noname - Song 31
Oh Land - Human Error
Chaka Khan - Hello Happiness
Aaron Watson - Kiss That Girl Goodbye
Hardwell - Being Alive
Old Sea Brigade - Cigarette
James Curry - Party on My Own
The Him - Unstoppable
Sting - Brand New Day - 2019 Version
Ryan Hurd - Michigan for the Winter
Danielle Bradbery - Psycho - Yours Truly: 2018
Adam Ambrose - Relax
Brian May - New Horizons - Ultima Thule Mix
Huron John - Friendzone
Dzeko - Heaven (feat. Veronica)
Big Wild - 6's to 9's
Velvet Two Stripes - Drinks
River Becomes Ocean - The End
Neon Dreams - High School Dropout
Set It Off - Midnight Thoughts
No Suits - Clothes Off
Bazanji - 2019
Young & Sick - Bitter End