Carlos Vives & Wisin - Si Me Das Tu Amor
Cheb Rubën - Billete de 500
Egwa - La Verdad
El Momo - Nada que ver
Fuego & Nicky Jam - Good Vibes (Remix) ft. De La Ghetto, Amenazzy & C. Tangana
Gloria Trevi - Yo Soy Su Vida
H Roto - Rally ft. Duki & GARZI
J Alvarez - Enamórate ft. Jowell & Randy
J Balvin - La Rebelión ft. Joe Arroyo
Jeloz - Juntos
Jeycyn - Qué Estoy Buscando
Mariah & Myke Towers - Celos
Kany García - Quédate ft. Tommy Torres
Lalo Ebratt - Déjate Querer ft. Sebastián Yatra & Yera
Los Chikos del Maíz - Valerie Solanas (Stop Making Stupid People Famous)
Lyanno - Pa' Que Vuelvas
Maluma - HP
Nacho - Nadie Sabe
Remmy Valenzuela - Mentiras
Shotta - Viejos sabios ft. Dirty Porko y Crie 930
*Sou El Flotador - La Modelo ft. Gotay
Sule B - Ave Fénix
Tempo - Sí A La Vida ft. Gustavo Laureano & Elysanij
*Yomo - Quédate Conmigo ft. Jorsh
Ximena Sariñana - Cobarde02/03*RKO - Dile03/03Pusho - Auxilio
Ysy A - NATI04/03Carlitos Rossy - Se Daño
Duki & C.R.O. - Rosa05/03Denom - Déjame volar
iLe - Temes
Jaudy - Si Mañana Me Muero
Pablo Chill-E - Mambo Gang
Tony Dize - No Me Equivoco06/03*Dash - Replay ft. Chriss Romero
Luisa Fernanda W - Que Hay Detrás07/03Bryant Myers - Tanta Falta (Remix) ft. Nicky Jam
Mark B - Hoy08/03*Alexander DJ - Sin Mente ft. Cheka & Golden Gun
Andrés Calamaro - Gibraltar (Canción Original para la Película Taxi a Gibraltar)
Anonimus - Karma ft. Lyanno & Rauw Alejandro
Arevalo - Casa En El Aire
Bhavi - 9070 (Live Session)
*Caifanes - Heridos
Cauty - Ironía ft. Myke Towers
Dvicio - Valeria
El Villano - Chica Oficial
Emilia Mernes - Recalienta
Feid - Buena Mala ft. Alizzz
Frank Jordan - Al Callao
Fuego - Bien Fancy ft. Greeicy
Gente de Zona - El Mentiroso ft. Silvestre Dangond
Gotay - Mami ft. Gigolo & La Exce
Helado Negro - Fantasma Vaga
Helado Negro - Sábana de Luz
Helado Negro - Todo Lo Que Me Falta
IAmChino - Sólo Tú ft. Tito El Bambino
INNA - Tu Manera
*Jeloz - Salgamos
Jhay Cortez & Mariah - Costear (Remix)
Kapla y Miky - Si Tú
Kevin Roldan & Ayo Jay - Estrella
Leslie Shaw & Mau y Ricky - Faldita
Maite Perroni - Roma ft. Mr. Rain
Matt Hunter - Una Vez Más ft. Tommy Boysen
Mike Duran - Se Descontrola ft. Jory Boy
Natalia Jiménez - Nunca es Tarde ft. Jesús Navarro
Noriel - KaRma (Remix) ft. RKM & Ken-Y, Darkiel & Divino
Ñejo - Mi Leona ft. Guaynaa
Pusho - No Aguanto ft. Alex Rose, Myke Towers & Lyanno
*Sou El Flotador - Decídete ft. Marvel Boy
Yandel - Que No Acabe
Yanyo The Secret Panta - Se Nos Dio ft. Darell, Ñengo Flow & Jhay Cortez & Myke Towers10/03Ezra Howard - En mi Colegio Siempre Regio11/03Boza - Me Mató
Cami - He Venido Por Ti
KYOTTO - Diablo12/03Danny Ocean - Cuando Me Acerco A Ti13/03Danny Ocean - Babylon Girl
Jon Z & Enrique Iglesias - Después Que Te Perdí
Ozuna - Vacía Sin Mí ft. Darell14/03Cheb Rubën - Inspiración
Danny Ocean - Tel Aviv
Mau y Ricky - Perdóname15/03Alex Sensation - Be Mine ft. Daddy Yankee, Sean Paul & Pinto
Anonimus - 4 Life
Danny Ocean - Gime
Darkiel - Dicen ft. J Alvarez
Dbwoy, Cauty & Gino Mella - No Es Fácil
Dj Nelson - ¿Una Mujer? ft. De La Ghettlo, Darell & Brytiago
Ele A El Dominio - Lo Mismo ft. Pusho
Gianluca - Sismo ft. Pablo Chill-E
Gloria Trevi - Hijoeputa ft. Karol G
Greeicy - Destino ft. Nacho
Green Cookie - Volverla ft. Casper Mágico
Jan Paul - Otra Pa La Historia ft. Jory Boy, Ñengo Flow & Gotay
Marconi Impara - Brinquen
Mozart La Para & Tainy - Bárbaro
Nova & Jory - Bien Loco (Remix) ft. Ñengo Flow, Nio García, Casper Mágico, Gigolo & La Exce, Cauty & Brray
Rauw Alejandro - El Efecto ft. Chencho
RKM & Ken-Y - Una Noche Más
Sean Paul - Contra La Pared ft. J Balvin
Social Club Misfits - Que lo Que
Sofía Reyes - R.I.P. ft. Rita Ora & Anitta
Sule B - Stoichkov ft. Juancho Marqués
Wapea & Feid - Maldita17/03Daniela Legarda - Eterno
Natos y Waor - Flawless18/03Cheb Rubën - Calidad y cantidad
Danny Ocean - Kizombita Para Ti
Duki - Vapormax
Jona Alk — Perdición ft. HippyMigué19/03Danny Ocean - Muérdago
Denom - Medicina
Mackie - Me Provocas20/03Danny Ocean - Tuyo Mía21/03C.R.O. - Money
Danny Ocean - Báilame
Reik - Duele ft. Wisin & Yandel22/03Big Soto - Grosero (Remix) ft. Álvaro Díaz & De La Ghetto
Brytiago - Aprendí a Amar
Chris Wandell - Me Lo Juré ft. Amarion
Danny Ocean - Veneno
Eladio Carrión, Amenazzy & Rauw Alejandro - Se Moja ft. Noriel
Fuego & Saox - Sauce
J Alvarez & Olga Tañon - Qué Fluya
*K2 - Mi Naturaleza ft. Feid & Biá
Maximus Wel - Veneno
Myke Towers - Sin Prendas Yo Brillo ft. Jon Z
Nicky Jam - Te Robaré ft. Ozuna
Oana & Reykon - Sisas
Omy De Oro & Jory Boy - No Es Real
Paloma Mami - Fingías
Rafa Pabön - Ya No
Rubiel Internacional - Si Te Cansaste (Remix) ft. Darkiel, Divino & Elysanij
Sebastián Yatra - Cristina
Seven Kayne - Buenos Aires ft. Khea & Bhavi23/03Lucho SSJ - Ligas Mayores ft. plugboy.6k & 0-60025/03Ovy On The Drums - El Amor Sí Va27/03Dalex - Vuelva a Ver Remix
Neo Pistea - Tumbando el Club (Remix) ft. Cazzu, Obie WanShot, Khea, Duki, Ysy A, Lucho SSJ, C.R.O, Marcianos Crew & Coqeéin Montana28/03DJ Luian & Mambo Kingz - Verte Ir ft. Brytiago, Nicky Jam, Darell & Anuel AA
ROSALÍA & J Balvin - Con Altura ft. El Guincho29/03DaniLeigh - Lil Bebe (Bebecito Remix) ft. Rauw Alejandro & Nio García
Dayme & El High - Sola ft. Khea, Alex Rose, Myke Towers
Josimar y su Yambú - Tributo a Chacalón
Lary Over - Amores
Lunay - Llégale ft. Zion & Lennox
Maffio - Cristina ft. Justin Quiles, Nacho & Shelow Sha
Miky Woodz - No Siento Nada
Reykon - Domingo (Remix)Por Anunciar*Anuel AA - Por Ley
*Herencia De Timbiquí -  Mi Primera Locura ft. J Alvarez
*Zion & Lennox - Guayo ft. Anuel AA