Ariana Grande - 34+35
Olivia Rodrigo - good 4 u
Dua Lipa - Love Again
Doja Cat - Kiss Me More (feat. SZA)
Billie Eilish - Your Power
Rihanna & JAY-Z - Umbrella
Lady Gaga - Stupid Love
KAROL G & Mariah Angeliq - EL MAKINON
Adele - Easy On Me
Halsey - I am not a woman, I'm a god
SZA - Good Days
Sia - Chandelier
Miley Cyrus - Angels Like You
Nicki Minaj - Super Bass
Megan Thee Stallion - Thot Shit
Lana Del Rey - If You Lie Down With Me
Selena Gomez - Rare
Kate Perry & Snoop Dogg - California Gurls
Beyoncé - Formation
Cardi B - Up
Shakira - Don't Wait Up
P!nk - All I Know So Far
Camila Cabello - Don't Go Yet
Ava Max - My Head & My Heart
Maria Becerra - Wow Wow (feat. Becky G)
Britney Spears - Gimme More
Kali Uchis - telepatía
Tate McRae - feel like shit
Marília Mendonça - Troca de Calçada
Becky G & El Alfa - Fulanito
Anne-Marie & Little Mix - Kiss My (Uh Oh)
Bebe Rexha - Sacrifice
Lorde - Solar Power
ROSALÍA - LA FAMA (with The Weeknd)
Natti Natasha & Becky G - Ram Pam Pam
Melanie Martinez - Play Date
Ellie Goulding, Diplo & Swae Lee - Close To Me
Julia Michaels - Lie Like This
Mitski - Washing Machine Heart
Saweetie - Tap In
Summer Walker - No Love (with SZA)
Anitta - Girl From Rio
Mariah Carey - We Belong Together
YOASOBI - 怪物
Tones And I - Fly Away
TINI & Maria Becerra - Miénteme
Alicia Keys - Love Looks Better
Clairo - Amoeba
Whitney Houston - I Wanna Dance With Somebody (Who Loves Me)