Post Malone - Cooped Up (with Roddy Ricch)
Florence + The Machine - Dream Girl Evil
Burna Boy - Last Last
The Chainsmokers - I Love U
Tate McRae - what would you do?
My Chemical Romance - The Foundations of Decay
Kendrick Lamar - Die Hard
DaBaby - WIG (with Moneybagg Yo)
Becky G - BAILÉ CON MI EX
OneRepublic - I Ain't Worried
Kendrick Lamar - Silent Hill
Måneskin - SUPERMODEL
Morgan Wallen - You Proof
Bazzi - Will It Ever Feel The Same?
Gryffin - Caught Up (with Olivia O'Brien)
John Summit - In Chicago
The Black Keys - For the Love of Money
Vory - Do Not Disturb ft. NAV and Yung Bleu
Remi Wolf - Michael
Sasha Alex Sloan - Adult
5 Seconds of Summer - Me Myself & I
Shygirl - Firefly
Yvngxchris - DAMN HOMIE (feat. Lil Yachty)
UMI - moonlit room
Joy Oladokun - Purple Haze
Elle King - Worth A Shot (feat. Dierks Bentley)
Noah Cyrus - Mr. Percocet
Why Don't We - Just Friends
Okaywill - Tomorrow
Aldn - bargaining (with Verzache)
Ethel Cain - Hard Times
Mark Ronson - Too Much (feat. Lucky Daye)
Davido - Stand Strong (feat. Sunday Service Choir)
Muni Long - Pain
TOMORROW X TOGETHER - Good Boy Gone Bad
ILLENIUM - Shivering (feat. Spiritbox)
James Bay - One Life
Peter McPoland - Slow Down
Renforshort - we'll make this ok (with Travis Barker)
Pardyalone - not a home
Ingrid Andress - Seeing Someone Else
Ne-Yo - Don't Love Me
Dougie B - I'm Back
The Smile - Thin Thing
Johan Lenox - Hitting Different
Sub Urban - CANDYMAN
Two Feet - ADHD
Pale Waves - Lies
Death Cab for Cutie - Roman Candles
Leith - Satellite
Lil Eazzyy - Bring Some Mo (feat. NLE Choppa)
Fresco Trey - Facts
Trueno - TIERRA ZANTA
Wet - Tell Me Why
Maude Latour - Trees
Anna of the North - Meteorite
Ayokay - Amnesia (with Nightly)
Benny Benassi - LIGHTWAVES
Danger Mouse - No Gold Teeth
Feid - Castigo
A$AP ANT - Fly Away
Prentiss - cardigan
Allison Ponthier - Hardcore
Julia Jacklin - Lydia Wears A Cross
Mallrat - To You
Galantis - 1x1
Cris Mj - Empezamos de 0
Sofía Valdés - In Bloom
Kevin Morby - Bittersweet, TN
Obongjayar - Wrong for It
Leikeli47 - Carry Anne
DaniLeigh - Dead To Me
Dreezy - Balance My Lows (feat. Coi Leray)
GMK - Born To Be Free
Felicita - Cluck
Chloe Adams - Seasons
Stacey Ryan - Fall In Love Alone
G Flip - GET ME OUTTA HERE
PmBata - i hate her boyfriend's face
Waterparks - FUNERAL GREY
Teenage Disaster - Chop Chop
MIKA - Yo Yo
Mandy Moore - Brand New Nowhere
Ricky Rosen - Home
King Combs - Gas You Up
Starcrawler - Roadkill
State Champs - Act Like That
Paolo Nutini - Through The Echoes
Spencer Crandall - What Do We Do Now?
Tank and The Bangas - Communion in My Cup (feat. The Ton3s)
Anna Mae - Hallelujah
Niina - miss me
Swansea Skag - Ester
Blac Youngsta - We Kept the Receipts
Sadie - Where You're Not
Number One Popstar - Dance Away The Pain
Hello Yes - Peace of Mind
Morgxn - PRETEND RAINBOW
Chrissy - SocksYou might also like