Migos - Stir Fry
Huncho Jack - Eye 2 Eye feat. Takeoff
Gavin James - Hard To Do
Imagine Dragons & Khalid - Thunder / Young Dumb & Broke (Medley)
Anitta - Vai malandra feat. Tropkillaz e DJ Yuri Martins
Good Charlotte - Awful Things
Kesha - This Is Me
Gucci Mane - Peepin out the Blinds
Alex Aiono & T-Pain - One At A Time
Nipsey Hussle - Been Down feat. Swizz Beatz
Tofer Dolan - Electric Heart
BLVK JVCK - Mine Luv feat. H.E.R
Sugarland - Still The Same
Bonnie McKee - Thorns (Le Youth Remix)
YoungBoy Never Broke Again - War With Us
Tyga - Temperature
Griffin Stoller - Down for Love
Mat Kearney - Don't Cry For Me
Whethan - Aftertaste feat. Opia
Kasbo - Snow In Gothenburg
Lil Skies - Nowadays feat. Landon Cube
NIKI - Chilly
Kap G & Spoken Arcane - Do It Cuz ILY
PLAZA - All Mine
Captain Kidd - Wild
Thirty Seconds To Mars - Walk On Water (R3hab Remix)
Ozuna - La Modelo feat. Cardi B
Cassie - Don't Play It Safe
Machine Gun Kelly - Habits
Dillon Francis - Hello There (Happy Colors Remix) feat. Yung Pinch
King Combs - Feeling Savage feat. Smooky MarGielaa
Joshua J - Flowers feat. Eauxby
Jonathan Wilson - Over the Midnight
Black Veil Brides - The Last One
Dan Auerbach - Cellophane Angel
First Aid Kit - Perfect Places (Live From BBC Radio 2)
Jadu Heart & Mura Masa - unevercallmebutidontmindbecauseimintheclubâ€‹ (Jadu VIP)
Tchami - World To Me (MK Remix) feat. Luke James
Jan Blomqvist - Winter Roads
The-Dream - It's Yo Birthday
Palm Trees - Outside feat. MdL & Abi F Jones
James Mercy - Fractures feat. Ameria
Alesso & Anitta - Is That For Me (3LAU Remix)
Scavenger Hunt - Ghosts
BETSY - Heavy Head (Acoustic)
Brasko - Take Me
Dr Vades - You're The One
Mally Mall - Physical feat. Jeremih & E-40
Ayo & Teo - Like Us
Madison Mars - Magneto
Telykast & Lemay - Fall Down On Me
Frills - We Can Be Friends
Dropgun & Natan Chaim - Really Mine
Nohidea - psilocybin feat. Sleepdealer