Anitta & J Balvin - Downtown
Gwen Stefani - You Make It Feel Like Christmas feat. Blake Shelton
Dua Lipa - New Rules (Initial Talk Remix)
Little Mix - Is Your Love Enough?
Blackbear - anxiety feat. FRND
Jadu Heart & Mura Masa - U​ ​Never​ ​Call​ ​Me
Yellow Claw - Both of Us feat. STORi
Kodak Black - Codeine Dreaming feat. Lil Wayne
Roy Woods - Balance feat. dvsn & PnB Rock
Björk - Arisen My Senses
Noel Gallagher's High Flying Birds - She Taught Me How To Fly
Phoebe Bridgers - Have Yourself a Merry Little Christmas
BTS - MIC Drop (Steve Aoki Remix) feat. Desiigner
One Bit & Noah Cyrus - My Way
Basenji - Mistakes feat. Tkay Maidza
DRAM - #1HappyHoliday
G-Eazy - Summer In December
Farruko - Krippy Kush (Remix) feat. Nicki Minaj, Bad Bunny, 21 Savage & Rvssian
Kehlani - Already Won
Why Don't We - Kiss You This Christmas
Amy Shark - Adore (Piano Unplugged)
Craig David - I Know You feat. Bastille
Vice - Piñata feat. BIA, Kap G & Justin Quiles
All Tvvins - Crash
50 Cent - Still Think I'm Nothing feat. Jeremih
Carlie Hanson - Only One
Forever in Your Mind - Rabbit Hole
Stanaj - Last Christmas
Cole Swindell - This Is How We Roll
Fabolous & Jadakiss - Talk About It feat. Teyana Taylor
Clean Bandit - I Miss You feat. Julia Michaels (Naations Remix)
Basic Tape - Cool feat. Huntar
LUI HILL - 5000 Miles
Bohnes - My Friends
Unlike Pluto - I Need A Win
Steel Banglez - Bad feat. Yungen, MoStack, Mr Eazi & Not3s
Dylan Gardner - Can't Stop Thinking
Frank Turner - I Am Disappeared (Songbook Version)
Jack Vallier - Change Your Mind (Stripped)
Jim James - The World Is Falling Down
Ebenezer - Survival
Maths Time Joy - Only You feat. JMR
Hopsin - Ill Mind Of Hopsin 9
Big Shaq - Man's Not Hot (P Montana Afrobeat Mix)
Dahlia Sleeps - Rise
Fat Tony - Son Of God
Liam Payne - Bedroom Floor (Cash Cash Remix)
Isaac Gracie - Terrified
Lost Frequencies & Zonderling - Crazy
Icona Pop - Don't Slam the Door
Jake Paul - It's Everyday Bro (Remix) feat. Gucci Mane
Logan Paul - No Handlebars
Honors - Forever
Tim Atlas - Unwind
Kiera Weathers - Talk to Me