FRVR FREE - "Beautiful Day (House of the Lord)" ⏳
Rick Dorn - "It's Done"5/2Lorhann - "Protegido" ⏳
Luciano Corti - "CON EL VIENTO" ⏳5/3Abe Parker - "Self Sabotage"
Sinach - "Amazing God"5/4Слово жизни Music - "Спишь в лодке" ⏳
Julissa - "Lo Primero"
Marvin Sapp - "You Kept Me" ⏳
Poor Bishop Hooper - "Psalm 123"
Vision of Leo & Edgar Sandoval Jr - "Bucky’s Hand" ⏳5/5Danny Richard - "Busy"5/6Aallonmurtaja - "Vielä on aikaa"
Aaron David - "Good Day" ⏳
Adriel Cruz - "Bad Kid Great God" ⏳
Art Martinez Jr. - "How Great Thou Art" feat. Eliza King ⏳
Ben Lawrence & J.Steph - "What You Poured Out" ⏳
Bruyere - "Sol di mezzanotte" ⏳
Bryan & Katie Torwalt & Cody Carnes - "Simple Kingdom (Live)"
CalledOut Music - "Hold On Me"
CCV Music - "Standing Tall (Live)" ⏳
Christ Church Manchester Music - "Love Me Likе This"
Christian Singleton & Ben Trip - "Love Likе Yours"
Christopher Syncere - "TOO MUCH PRESSURE" feat. Coop & Henrik
CieMie - "idek"
Citizens - "Everything & More"
Dan Bremnes - "No One Loves Me Like You Do"
Davy Flowers - "I Was Loved"
Ekofall - "A Civil Blood" feat. Mikey Powell ⏳
Faith Lofi - "bliss"
Fearless BND - "Everything"
Fight The Fade - "Where You Go I Go"
Fyr Fytr - "I Know That It Won't Be Long" feat. Chris Miller & Zambroa ⏳
Gatherhouse Music - "You Are Glorious" feat. David Gentiles
Heaven and Earth Worship - "In the Light"
Ilish - "Overthinking II" ⏳
indie tribe., nobigdyl. & Jon Keith - "CECE"
Jakob Longfield - "When The Lights Fade Out"
Jessamyn Day - "Highways" feat. Daniel J. Bryant ⏳
Jimmy Levy - "Take The Lead" ⏳
JJ Heller - "Heard It from a Friend"
Jordan Kelch - "Debates" ⏳
Jorge Olliver - "Ah, Se Eu Pudesse Voar"
Joseph Goulding & HYLEM - "Run To You"
JXHN PVUL - "tú me entretienes" ⏳
Kevin Levar - "The Only Thing That Matters" ⏳
King Dareal - "OBIMO" ⏳
Knaladeus - "Demic Thoughts" feat. Dstl & Jewell Jones ⏳
Konata Small - "Impossible" ⏳
LifePoint Music & Jordan Strickland - "Joy of My Lord (Live)" ⏳
Lindy Cofer & Circuit Rider Music - "Lord Of The Harvest (Live)"
Lizzy Parra & Angel Brown - "Cielo" ⏳
Lucy Grimble & Graham Kendrick - "The Cross Has Spoken" ⏳
Manor Collective - "Shelter" feat. Becca Folkes, Tertia May & CalledOut Music
Marcelo Sissá - "Artifício"
Mike Teezy - "Ram in the Bush"
Nacee - "Nomnsu" ⏳
Nashbi & Master Steve - "All I Need." ⏳
Nicole Serrano - "The Joke"
Niko Eme & Jay Kalyl - "Futuro Contigo" ⏳
Novo Tempo - "Além do Que Se Vê" feat. Jeferson Pillar, Tatiana Costa, Os Meireles & Weslley Fonseca
Nueva Raza Music - "Centro"
Olivia Grasso - "Sidelines"
Petrus Ahonen - "Aurinko paistaa" ⏳
Princeton South & Asha Elia - "Unguilty Pleasure" ⏳
Reece Lache' - "Lmk" ⏳
Ryan Stevenson - "I Cry Jesus"
Saint Asonia - "Above It All"
Savanofsky - "North Hollywood" ⏳
Scootie Wop - "SPIN BACK!"
Sesiones Acústicas - "A Pesar De Mí"
Seth Benjamin - "Fly A Kite" ⏳
SEU Worship - "Tell All My Friends" feat. Sydney James
Sharp Dialect - "In Your Hand"
Sondae - "Raise Me Up" feat. BINDANG
Southland Music - "No More"
Spencer Annis - "Father Heart"
Steph Andrews - "The Architect"
TAYA - "Getaway"
The Belonging Co & Natalie Grant - "This Is Freedom (Ain’t No Rock) [Live]"
The Porter's Gate - "The Kingdom Is Coming" feat. Josh Garrels & Terrian
UPPERROOM & Toma Tu Lugar - "Primer Amor (Live)" feat. Nick Gaggero & Marcos Brunet
1K Phew - "Offering"5/7Hi Key Records - "Мама помолись за меня" ⏳
1k Pson - "Enough" feat. Tasha Renee ⏳5/8Frankie Leo - "Mama" ⏳
Kana Band - "Надія (Nadiia)" ⏳5/9Sarah Nathalié - "VANILLA" ⏳5/10Eddie James & Fresh Wine Music - "I've Been Washed" feat. Heath King
Jessé Aguiar - "A Reforma"
João Manô, Coletivo Candiero & Filipe da Guia - "Os Anos de uma Alma" feat. Rev. Emilio Garofalo Neto ⏳
Spring City - "Raise Our Hands" feat. Annielle, MIAH & Noomi ⏳5/11Bec Armour - "The Blind Man" ⏳
Jesus Wannabeez - "Wage The War (Ephesians 6)" ⏳
Poor Bishop Hooper - "Psalm 124"
SIV & Moflo Music - "I Can't Wait" ⏳5/12Convergência Music & Larissa Porto - "Deixei Tudo para Trás"
JordanOfYHWH - "In The Sky" feat. Dezyohreally ⏳
Untidld, QEW & TC - "Grateful" ⏳
Zach G Wilson - "Heavens"5/13Adinda Shalahita - "Pulang" ⏳
Alex Campos & Angie Rose - "Agua"
Alexis Spight - "God Still Works" ⏳
Alvin Cedric - "For Me, For You"
AWAKE84 - "Here Now" ⏳
Benjamin Hastings - "Anyway"
Black Voices Movement & Circuit Rider Music - "For Jesus (Live)" feat. Alvin Muthoka ⏳
breezy down - "theory"
Caleb Gordon - "Pop Out Clean"
Caziah Rashad Franklin - "Home" ⏳
Charla Peterson - "Content" ⏳
Collington - "Fighting For Me"
Davido & The Samples - "Stand Strong"
Deitrick Haddon - "Here Comes the Joy" ⏳
Don Ready, Xay Hill & Kelo - "Do What it Take" ⏳
Dr Tumi - "The 4th Man" ⏳
Glorya Reliques - "Silence" ⏳
Grace Peremot - "Ты Не Далеко" ⏳
Grace Union - "Captive Heart"
Hannah Sloots - "Hall Light" ⏳
Hillside Recording - "Joy of the Lord"
Jake Hamilton - "Gasoline" ⏳
James Paek - "Young Love"
John Michael Howell - "BURN BURN BURN" ⏳
K-SEE, Lazarus! & Battz - "Kseeundercover II" ⏳
Kaiu - "Saved"
Keith & Kristyn Getty - "Come To Jesus (Rest In Him)" feat. Jordan Kauflin & Matt Merker
KEO - "Home"
Ki Alexis - "Sweet Jesus" ⏳
Kris Noel - "WHATEVER YOU ON" feat. Alcott & Quodraveion ⏳
Krissy Nordhoff & Cecily - "How Good It Is (Even In The Winter)" ⏳
Lilmizzy - "Fire" ⏳
Many Cities - "Meander"
Maverick City Musica & Maverick City Music - "Tesoro" feat. Aaron Moses & Tianna
Miles Minnick - "Ghost" feat. Bizzle
Mireyli Rosa & Alexxander - "Picheo" ⏳
Monty G - "My Journey" ⏳
Muntjac - "Jubilee Day" ⏳
muted mike - "Never Before You" ⏳
MvkeyyJ - "tell me twice" feat. Rockstar Jt ⏳
Nathan Wagner - "Narrow Road"
Natural State - "We're Alive"
ORU Worship - "Rivers of Joy"
PRESTXN - "realize"
RAY G & OnBeatMusic - "BEST NIGHT" feat. Joey Vantes & A. Ruiz ⏳
Ryan Ellis - "Gonna Be Alright"
Saint James & Faith Lofi - "All I Need"
Spencer Boliou & Lofi Hymns. - "blood."
Swingin Hammers - "Hold the Line"
Tailah - "Radiant" ⏳
Tauren Wells - "Come Home"
Tee Supreme - "Kingdom Bop" feat. Limoblaze ⏳
Tenielle Neda - "Love Cuz We're Loved" feat. Paul Zach
The Worship Initiative - "Come, Lord Jesus, Come" feat. Aaron Williams & Davy Flowers
The Worship Initiative - "Refuge" feat. Shane & Shane
UPPERROOM & Toma Tu Lugar - "Desirable (Live)" feat. Abbie Gamboa, Joel Figueroa & Marcos Brunet
UPPERROOM & Toma Tu Lugar - "This Is Where I Belong (Live)" feat. Abbie Gamboa, Joel Figueroa & Marcos Brunet
Uzuhan - "Home (sic)"
Xandria Cross - "Air Force" ⏳
121SELAH - "Shoe Maker" ⏳5/16Adia - "God of Dreams" ⏳
Paulo Nazareth - "Nem Por Isso Não É" ⏳5/17Annais - "Ma Adori" ⏳
Tracy Nitschke - "Reign Above It All" ⏳5/18Poor Bishop Hooper - "Psalm 125"5/19Caleb Gordon - "This My Season" ⏳
Darla Baltazar - "Self Righteous"
Dazy Chain - "Back 2 Back" ⏳
Fight The Fade - "On My Own"5/20adriansings - "ON THA SEAT" ⏳
After Grace - "Roots" ⏳
Alcott & Prodi Da Prodigal - "Play God"
Alexander Pappas - "OLDER"
Anthony David & Algebra Blessett - "Heaven"
Anu Eletu - "hands of God"
Arele - "Sobrevoar" ⏳
Avipa - "Confiar" ⏳
Awaken Music - "Revive Us"
Battz - "Be Real" ⏳
Ben Lawrence & Kat - "BITTER" ⏳
Bjéar - "Hotel" ⏳
Caitie Hurst - "Well Done" ⏳
Clemency - "Amazed"
Davy Flowers - "Oh But God"
Dewayne Harvey - "So Much I Can Do" ⏳
Don Ryvcko - "24/7" feat. Tommy Royale ⏳
Emissary - "Free?"
gio. & LOGE - "shadows"
Harborside Music - "Cerca" ⏳
Henrik - "CEMENT"
Ilish - "Waves" feat. Kemvr, Jekasole & Jay Sanon
indie tribe - "STERLING" feat. Mogli the Iceburg & Jon Keith
Influence Music & Whitney Medina - "Straight To Your Heart"
John Lucas - "Gasoline" feat. Nicole Tester ⏳
John Mark McMillan - "Ordinary Love"
Joseph Goulding & Xay Hill - "Broken" feat. tristxn! ⏳
Justin Rizzo - "Worship And Adore (Live)"
Katy Weirich - "Blue Jay" ⏳
KAYDEN - "HEY GOD" feat. David Ryan Cook
Kelo - "Need Your Love" ⏳
Kenny Rivers - "TRIBU" ⏳
Kenzie Katlyn - "Morning After" ⏳
Kirsten Faith Soldan - "Heaven"
Kojo Dave & Asha Elia - "Right Now"
Marcelo Sissá - "Forte"
Maverick City Music & Kirk Franklin - "Kingdom" feat. Naomi Raine & Chandler Moore
MBL Worship & Brennan Joseph - "As for Us (Exhortation) [Live]" ⏳
MBL Worship & Brennan Joseph - "Turn It Up (Live)"
Megan Duke - "It's What You Do" ⏳
Mia Pearl - "Sweet like Surrender" feat. LéahRae & Michael Amaechi ⏳
MUCH MORE - "forbidden fruit" ⏳
Mykyl - "HONEST WITH MYSELF" ⏳
Nathan Taylor - "Song of the Son" feat. Edtwan Barr
Omar Salas - "Vida"
Paul Russell - "JEANS"
Peterson Jean-Marie - "Moving Forward"
Rebekah Renatus - "Something Beautiful" ⏳
Reed Deming - "more like you" ⏳
Rend Collective - "Plans"
Renwick Duesbury - "No More Detours" ⏳
Rhett Walker - "All Joy No Stress" feat. Tedashii
Rick Harmoney - "UP" ⏳
Rijola - "na minútu" ⏳
River Valley Worship - "Straight to You (Live)"
Roy Tosh - "Don't Lose Heart" feat. Lynnea
Samantha Howard - "Lift Him Up" ⏳
Sammie Ekpoh - "Your Love" feat. Naffymar ⏳
Son of Cloud - "Sleeping in My Arms" ⏳
SONS THE BAND - "Kingdom Is Alive"
Starringo - "I’m Really Like This" ⏳
Swaizy - "fairytale" ⏳
The Belonging Co & Mitch Wong - "Rise And Shine (Live)"
The Jonah Project - "Psalm 88"
The Walls Group - "Crazy"
Tom Read - "63 (Shadow)"
Ty Brasel & 1K Phew - "GOD IS THE BEST"
VOUS Worship - "I Met Jesus In Miami"5/21Kkah$o & Kelo - "WAY MAKER" ⏳5/23HZY - "Chasing LA" feat. DJ Mykael V & 350 ⏳
World Worship - "Das Vida" ⏳5/24Eddie James & Fresh Wine Music - "Nothing but the Blood" feat. Heath King ⏳
Joel Leasure & Xay Hill - "Lonely" ⏳
Paula Prieto - "Si yo me voy" ⏳5/25Kaytez Kanu & Twr Music - "PERSUADED" feat. Daniel Alan ⏳
Omar Rodriguez Music - "Fuego" ⏳
Paula Prieto - "Yo nunca sé nada de ti" ⏳
Poor Bishop Hooper - "Psalm 126"5/26Gabrielle Grace - "Lost Somebody Else" ⏳
George.Rose & Mike Teezy - "HMU"
Morada - "Nosso General (Ao Vivo)" ⏳
Paula Prieto - "Lo que elegiste." ⏳
Thiago Riquette - "Agora Nós Dois" ⏳
Vancouver Sleep Clinic - "Blood Money"5/27Aaron Cole - "Glory"
Aaron Shust - "SIÃO" ⏳
Adai Music - "Jesus Único Caminho" ⏳
Ale Fdz - "Amanece" ⏳
Alvin Cedric - "Dreamer" feat. A3
Andrew Duhon - "Everybody Colored their own Jesus" ⏳
Aryn Michelle - "Cast a Stone (The Woman)" ⏳
AyeItsAron, 5ive & Kurtis Hoppie - "God Made"
Audrey Marie - "Facing Battles" ⏳
Autopilot Worship - "I Saw One" feat. First Pentecostal Church of North Little Rock Mass Choir
Barely Trev - "BUMMER" ⏳
Beach Chapel - "The Light"
Benji - "John Mark Pantana"
BigBreeze, Scootie Wop & Jude Barclay - "Wavy" ⏳
Caio Veríssimo - "Amar Você" ⏳
Caleb Gordon - "Macarena"
Cecily - "I’m Open" ⏳
Chris McQuistion - "This Is My Prayer" ⏳
Christ Church Manchester Music - "Always Faithful" feat. Anna Kell ⏳
Christian Singleton & Civilized Creature - "May The Words" ⏳
Damaris Guerra - "ECHO" feat. CRYS ⏳
DAMIAN - "Friend Forever" ⏳
Dee-1 - "More" ⏳
Dirk - "Caught Up in Your Love" ⏳
Em Busca de Sofia - "Fuga" ⏳
Evvie McKinney - "Church" ⏳
Forsaken Hero - "God Doesn't Care" ⏳
Free Worship - "Bless Him Some More" ⏳
Futures - "Who Is This Man"
Greg Colbeck - "Up Ahead" ⏳
HYLEM - "1,2,3" ⏳
Israel Salazar - "Fala" ⏳
Jaae Kash - "All I Need" feat. Miles Minnick and Jahmad Sax ⏳
Jesus People - "As You Can" ⏳
Joel Vaughn - "Friend"
John Jin Han - "Bright Eyed Boy" ⏳
John Van Deusen - "Boring" ⏳
Jonah Vocal - "Garden" ⏳
Joshua Luke Smith - "Something You Once Knew" ⏳
Kennis Clark - "Motive" ⏳
King Dareal - "SOTE" ⏳
K3ndrick - "Pictures On The Wall" ⏳
La Sociedad 111 - "Verte Vivir" ⏳
Manafest, UNSECRET, & GREYLEE - "Teardrops"
Manic Drive - "Love You to Death"
Marcos Martins & Kelwin Ramos - "Ressignificar" ⏳
Maria Segerholm - "Utvald" ⏳
Matthew Adams - "In Between" ⏳
Mayara Gabrielle & LLC Flame - "Rooted In Love" ⏳
Mike Sarge - "The Juice" feat. Shiwan
Milla Sampaio - "Haunt Me Too" ⏳
Miron Rafis - "Ibis Budget" ⏳
Naffymar - "Celebrate" ⏳
Nancy Daines - "Younger Self"
Naomi Raine - "Not Ready" ⏳
NCU Worship Live - "Jehovah in the Wind" feat. Skylar Burns & Keaton Goetz ⏳
Newsboys - "Jesus Did"
Nico Castro - "Diecisiete" ⏳
Paula Prieto - "Por que a ella si" ⏳
Ravenhill - "GUILTY VERTIGO" ⏳
Relena-Rochelle - "It’s Giving"
Ri-An - "Vagabond" ⏳
Rob Ray - "Dirty Clothes" ⏳
Saint Augustine's Music - "Evergreen (Psalm 1)" feat. Chloe Williams ⏳
Sam McCabe - "Prodigal God" ⏳
Samuel Day - "Meant To Be"
Sovereign Grace Music - "Praise His Name (Psalm 148) [Live]" ⏳
Steven Curtis Chapman - "Still"
Steven Malcolm - "Summertime (Remix)" feat. Jay-Way & Snoop Dogg
Switch - "This Is the Love" ⏳
The Belonging Co & David Ennis - "This Far (Live)"
The New Respects - "Don't Worry" ⏳
The Worship Initiative - "Gratitude" feat. Hannah Hardin ⏳
Tosin Bee - "Praise Party" feat. Mike Abdul & TESTIMONY JAGA ⏳
Tree Giants - "Better Together"
Tye Tribbett - "New" ⏳
Unspoken - "Hard Times"
Vic Lucas & Scootie Wop - "Look at Me Now" ⏳
VOUS Worship - "Awestruck" ⏳
We The Kingdom - "Miracle Power"
Woodlands Worship - "Break Out (Live)" ⏳
WYLD - "In the Morning" ⏳
WYLD - "One Another" ⏳
Zane Vickery - "I Never Left" ⏳
7 Hills Worship - "The Saints (Live)" ⏳5/30Aljava, Manuela Alves & José Jr - "Devoção" ⏳
Louis Pascal - "Holy Ghost" feat. Richbancs, Henry IX, Azariah Reign & Kevlar.BMG ⏳5/31Thomas Ware - "Never Cast One Stone" ⏳
Virtud Dc - "Eres Tú"
Wonderstate - "So In Love" ⏳