Matthew Koma - So Fuckin' Romantic
Kaptan - Everything
Rita Ora - Body On Me feat. Chris Brown
Birdy - Let It All Go feat. RHODES
Jim Adkins - Hell
Wiz Khalifa - Stayin' Out All Night feat. Fall Out Boy (Boys of Zummer Remix)
Carly Rae Jepsen - Making the Most of the Night
Mac Miller - 100 Grandkids
Fetty Wap - Again
Meg Mac - Never Be
EL VY - Return to the Moon (Political Song for Didi Bloome to Sing, with Crescendo)
Bee's Knees - Keeper feat. Chuck Inglish & Buddy
The Bohicas - The Making Of
Luke Bryan - Way Way Back
Hailee Steinfeld - Love Myself
Robert DeLong - Better Days
Ten Fé - Make Me Better
Half Moon Run - Trust
Madcon - Don't Worry feat. Ray Dalton
Oh Wonder - Drive
Silversun Pickups - Nightlight
Foals - A Knife in the Ocean
EDEN - End Credits
Health - FLESH WORLD (UK)
Libson - Natïve
Tiggs Da Author - Georgia
Never Shout Never - Hey! We OK
Robyn & La Bagatelle Magique - Set Me Free
Chevy Woods - Lookin' Back feat. Wiz Khalifa
Christopher - Tulips
Jordin Sparks - Work From Home feat. B.o.B
Method Man - The Purple Tape feat. Raekwon & Inspectah Deck
Warren G - Keep on Hustlin' feat. Jeezy, Bun B & Nate Dogg
Duke Dumont - Ocean Drive
Slaptop - Remember
Night Beds - Lay Your Hands
Lianne La Havas - What You Don't Do (Tom Misch Remix)
Moke Hill - Doing it Wrong
Grapell - Arrow
City and Colour - Wasted Love
Hunter Hayes - The Trouble With Love
James Bay - Let It Go (James Bay Spotify Session)
XY&O - Lights On
Ritual - Josephine feat. Lisa Hannigan
Photocomfort  - Not Love
Tongues. - Religion2