
The Temptations - "Ain't Too Proud To Beg"
Bob Dylan - "Tombstone Blues"
Reflection Eternal - "Memories Live"
Bob Marley & The Wailers - "So Much Trouble In The World"
The Isley Brothers - "Live It Up, Pts. 1 & 2"
Coldplay - "Paradise"
Mala Rodríguez - "Tengo un Trato" (remix)
Sly & The Family Stone - "Hot Fun in the Summertime"
Low Cut Connie - "Boozophilia"
Stevie Wonder - "Another Star"
Howlin' Wolf - "Wang Dang Doodle"
Nappy Roots - "Good Day"
Brandi Carlile - "Wherever Is Your Heart"
Okkervil River - "Down Down The Deep River"
The Rolling Stones - "Gimme Shelter"
John Legend - "Green Light"
Justin Timberlake - "Pusher Love Girl"
Florence + The Machine - "Shake It Out"
Sonora Carruseles - "La Salsa La Traigo Yo"
Aretha Franklin - "Rock Steady"

Night

Beyoncé - "Superpower"
Lianne La Havas - "Is Your Love Big Enough?"
Van Morrison - "Moondance"
Lauryn Hill - "Nothing Even Matters"
John Coltrane - "My Favorite Things"
Al Green - "How Can You Mend a Broken Heart"
Aoife O'Donovan - "Red & White & Blue & Gold"
Ray Charles - "You Don’t Know Me"
Frank Sinatra - "The Best Is Yet To Come"
Leonard Cohen - "Suzanne"
Joni Mitchell - "Help Me"
Mary J. Blige - "I Found My Everything"
Otis Redding - "I've Got Dreams To Remember"
Cassandra Wilson - "Until"
The Lumineers - "Stubborn Love"
Mos Def - "UMI Says"
Miles Davis - "Flamenco Sketches"
Billie Holiday - "The Very Thought Of You"
Nina Simone - "Feeling Good"
Erykah Badu - "Woo"You might also like9