Shawn Mendes - Nervous
A$AP Rocky - Praise The Lord (Da Shine) feat. Skepta
G-Eazy - Power feat. Nef The Pharaoh & P-Lo
Silk City - Only Can Get Better feat. Diplo, Mark Ronson & Daniel Merriweather
Juice WRLD - Lean Wit Me
Panic! At The Disco - High Hopes
Belly - What You Want feat. The Weeknd
Alec Benjamin - Let Me Down Slowly
Pusha T - If You Know You Know
Loote - Longer Than I Thought feat. Joe Jonas
Chelsea Cutler - Water on the Bridge
Lauv - Bracelet
Clairo - B.O.M.D. feat. Danny L Harle
Jonas Blue - Rise feat. Jack & Jack
RÜFÜS DU SOL - No Place
CHVRCHES - Graffiti
ZAYN - Entertainer
U2 & Cheat Codes - Love Is Bigger Than Anything In Its Way
Young Nudy - Since When feat. 21 Savage
Maggie Rogers - Fallingwater
Vistas - Tigerblood
YUNGBLUD - Psychotic Kids
Riley Clemmons - Better For It
Jorja Smith - February 3rd
R3HAB & Skytech - What You Do
YG - Big Bank feat. 2 Chainz, Big Sean & Nicki Minaj
Shawn Mendes - Like To Be You feat. Julia Michaels
J Balvin - Peligrosa feat. Wisin & Yandel
NIKI - Newsflash!
Taylor Swift - Delicate (Sawyr And Ryan Tedder Mix)
Glades - Not About You
Jade Bird - Furious
Influence Music & Michael Ketterer - Kingdom
Mike Shinoda - Running From My Shadow feat. grandson
Nicky Jam - Live It Up (Official Song 2018 FIFA World Cup Russia) feat. Will Smith & Era Istrefi
Hatchie - Bad Guy
Jackie Lee - Comeback
Emily Burns - Cheat
Welshly Arms - All The Way Up
Jesse James Solomon - Under the Sun feat. kadiata
Donna Missal - Girl
Crystal Fighters - Boomin' In Your Jeep
SHY Martin - Forget to Forget
Dierks Bentley - Burning Man feat. Brothers Osborne
Rudimental - Toast to our Differences feat. Shungudzo, Protoje & Hak Baker
Vacation Forever - I Changed My Life for You
CLOVES - Wasted Time
Snow Patrol - Heal Me
DREAMERS - SCREWS
The New Respects - Freedom
Jain - Alright
Train - Call Me Sir feat. Cam & Travie McCoy
Jessie J - Someone's Lady
The Him - Broken Love feat. Parson James
Always Never - No Good
Yellow Claw - Fake Chanel feat. A$AP Ferg & Creek Boyz
Denzel Curry - Percs
Lady Leshurr - OMW
Omar Apollo - Ignorin
A Boogie Wit da Hoodie - Way Too Fly feat. Davido
Rexx Life Raj, Lecrae & Mozzy - Blessings
Elderbrook - Sleepwalking
LOVA - Careful
Naji - Blood, Sex & Magic
Kassi Ashton - Taxidermy
Griffin Stoller - Burned
Good Charlotte - Actual Pain
Smino - New Coupe, Who Dis? feat. Mick Jenkins
Elley Duhé - AIN'T NO FEELING
Cosmo's Midnight - Lowkey feat. Buddy & Jay Prince
KWAYE - I Go
Andreas Moss - Deep Down Below feat. Yachtmoney
Hoobastank - Push Pull
Said the Sky - Over Getting Over You feat. Matthew Koma
Qveen Herby - ALL THESE HOES
HONNE - Location Unknown ◐ feat. Georgia
Keegan DeWitt - Hearts Beat Loud feat. Kiersey Clemons
Grapetooth - Violent
H O N E Y M O A N - We