Marshmello - Proud
Ed Sheeran - Best Part of Me (feat. YEBBA)
Ed Sheeran - BLOW (with Chris Stapleton & Bruno Mars)
Dreamville - Costa Rica (feat. Bas, JID, Guapdad 4000, Reese LAFLARE, Jace, Mez, Smokepurpp, Buddy & Ski Mask The Slump God)
Machine Gun Kelly - Glass House (feat. Naomi Wild)
Dominic Fike - Phone Numbers
iann dior - gone girl
blink-182 - Happy Days
Bonobo - Linked
Marshmello - Run it Up
Sam Fender - Will We Talk?
ROSALÍA - Milionària
Dimitri Vegas & Like Mike - Instagram
Dounia - DELIGHTFUL
Rick Ross - BIG TYME
Jaden - Summertime In Paris
Au/Ra - Dance in the Dark
03 Greedo - Cellout
Jason Derulo - Mamacita (feat. Farruko)
Belle & Sebastian - Sister Buddha
Jeezy - 1 Time
Mahalia - Simmer (feat. Burna Boy)
YBN Almighty Jay - Spaceship
Lil Gotit - Pop My Shit
DeathbyRomy - Dangerous (feat. blackbear)
Scarlxrd - ASK
Devin The Dude - Somethin' To Ride With
Ty Segall - Radio
Boom Forest - Damages
Press Club - Thinking About You
Mick Flannery - Fool
Snow Patrol - Time Won't Go Slowly
Mokita - More Than Friends
Matt Hunter - Problemas
Dana Vaughns - Rough Rider
Ta-ku - White
Flux Pavilion - Somebody Else
Stafford Brothers - Live Forever
BTS - Lights
Jacob Collier - It Don't Matter (feat. JoJo)
Cassie - Hungover
Raphael Saadiq - Glory to the Veins (feat. Ernest Turner)
Rich Rocka - Friends
No Suits - Sue
laye - sicker
Noah Slee - Soulflower
Amber Run - Affection
Blithe - Masochistic
Rayven Justice - Whistle (feat. Iamsu!)
Aloe Blacc - Getting Started (Hobbs & Shaw) [From "Songland"]
Dirty Heads - Lift Me Up
Fangclub - Vulture Culture
Twinnie - Social Babies
Jenni Rivera - Aparentemente Bien - Versión Banda
Mat Zo - Motivate
SimxSantana - FLEXIN N' FLASHIN
Eyelar - Voices
BEXY - Wish We Had History
Beachwood - Love Me Or Leave Me Alone
Piso 21 - Una Vida Para Recordar
SoMo - Visualize
Brooke Candy - XXXTC (feat. Charli XCX & Maliibu Miitch)
Max B - Black and I'm Proud
Summer Salt - Honeyweed
Griff - Mirror Talk
Becca VanDerbeck - Summertime
Rak-Su - Rotate (Clockwise)
Türküm - BEAST