Logic - Icy (feat. Gucci Mane)
Avicii - Tough Love
Russ - Civil War
Mary J. Blige - Thriving (with Nas)
Ari Lennox - BMO
blink-182 - Blame It On My Youth
Mustard - 100 Bands (feat. Quavo, 21 Savage, Meek Mill & YG)
David Guetta - Stay (Don't Go Away) [feat. Raye]
Lil Keed - Proud Of Me (feat. Young Thug)
Gia Woods - One Big Party
Major Lazer - Can't Take It From Me (feat. Skip Marley)
SG Lewis - Flames (feat. Ruel)
Jhene Aiko - Triggered (freestyle)
Logic - COMMANDO (feat. G-Eazy)
Ciara - Beauty Marks
Ingrid Michaelson - Missing You
Barns Courtney - You And I
Madonna - Crave (with Swae Lee)
LIVVIA - Dizzy
James Bay - Bad
Smokepurpp - Walk On Water
Marlo - Soakin Wet
$uicideBoy$ - nothingleftnothingleft ($UICIDEBOY$ X TRAVIS BARKER)
Bene - Evil Spider
Leven Kali - 1 On 1
James Arthur - Falling like the Stars
Carly Rae Jepsen - Too Much
teamwork. - Afterhours
ZAYN - A Whole New World (End Title) - From "Aladdin"
Skepta - Greaze Mode
jesse saint john - Alex's Song
AURORA - The River
Aazar - Diva (with Swae Lee & Tove Lo)
Dimitri Vegas & Like Mike - Best Friend's Ass (feat. Paris Hilton)
Stunna 4 Vegas - Ashley (feat. DaBaby)
Meghan Trainor - Badass Woman
Kim Petras - Blow It All
A$AP Ferg - Pups (feat. A$AP Rocky)
Denzel Curry - RICKY
OMB Bloodbath - My Body
Lunay - Soltera - Remix
CXLOE - Low Blow
John The Blind - Paranoid
Luke Combs - Beer Never Broke My Heart
Dinah Jane - Retrograde
gnash - i'm so sad
Quando Rondo - Imperfect Flower
Mac DeMarco - On The Square
Young Nudy - Shotta (feat. Megan Thee Stallion)
Whethan - Let Me Take You (feat. Jeremih)
Ambjaay - Uno
Mike Bahía - La Lá
Charly Bliss - Young Enough
ILOVEMAKONNEN - Drunk on Saturday
Elohim - braindead
R3HAB - Don’t Give Up On Me Now (with Julie Bergan)
Mozzy - Winning (feat. Lil Poppa)
Yung Pinch - Wink Emoji (feat. GASHI)
Juke Ross - Burned By The Love
83 Babies - No Cap (feat. Rich The Kid)
Grace Carter - Don't Hurt Like It Used To
girl in red - dead girl in the pool.
Jamila Woods - BALDWIN
Tee Grizzley - Locked Up
Calboy - Caroline (feat. Polo G)
Shaggy - Body Good (feat. Nicky Jam)
Sam Feldt - Magnets (feat. Sophie Simmons)
Gorgon City - Go Slow (with Kaskade)
Flying Lotus - More
SAFE - Red Light
Marc Anthony - Lo Que Te Di
MK - Body 2 Body
JAMESDAVIS - I Will
Isaac Dunbar - cologne
Phantom Planet - BALISONG
Jay Gwuapo - From Nothing (feat. Lil Tjay & Don Q)
Valentino Khan - Pony
mxmtoon - prom dress
Silversun Pickups - Freakazoid
Generationals - I Turned My Back on the Written Word
Raveena - Mama
FISHER - You Little Beauty
In Real Life - Somebody Like You
Lightshow - Your Side, My Side (feat. Wale)
Yoshi Flower - validation
Maxo Kream - She Live (feat. Megan Thee Stallion)
D Savage - WYTD
Vanic - Save Yourself
Dalex - Cuaderno
Shoreline Mafia - Vicious
Emotional Oranges - Good To Me
Moontower - Part 2
Vince Gill - A Letter To My Mama
Crumb - Ghostride
Jean Watts - Feel The Same
Eddington Again - Sweet
MEMBA - Walls Down
Dutch Melrose - White Wine