J. Cole - MIDDLE CHILD
Meek Mill - Going Bad feat. Drake
Polo G - Pop Out feat. Lil Tjay
City Girls - Act Up
Nipsey Hussle - Racks In The Middle feat. Roddy Ricch and Hit-Boy
Megan Thee Stallion - Cash Shit feat. DaBaby
Saweetie - My Type
Young Thug - Hot feat. Gunna
A Boogie Wit da Hoodie - Swervin feat. 6ix9ine
21 Savage - a lot
Blueface - Thotiana
Drake - Money In The Grave feat. Rick Ross
Tyler, The Creator - EARFQUAKE
Mustard & Roddy Ricch - Ballin'
Wale - On Chill feat. Jeremih
Young Thug - The London feat. J. Cole & Travis Scott
Baby Keem - ORANGE SODA
Lil Tecca - Ransom
YG - Go Loko feat. Tyga & Jon Z
Lil Nas X - Panini
Doja Cat - Juicy feat. Tyga
Flipp Dinero - How I Move feat. Lil Baby
Tory Lanez - Freaky
Megan Thee Stallion - Hot Girl Summer feat. Nicki Minaj & Ty Dolla $ign
Post Malone - Wow.
NLE Choppa - Shotta Flow
Benny The Butcher - 18 Wheeler feat. Pusha T
Rick Ross - Gold Roses feat. Drake
Young M.A - BIG
Dreamville - Down Bad feat. JID, Bas, J. Cole, EARTHGANG & Young Nudy
YoungBoy Never Broke Again - Make No Sense
Freddie Gibbs & Madlib - Palmolive feat. Pusha T & Killer Mike
DaBaby - BOP
DJ Khaled - Wish Wish feat. Cardi B & 21 Savage
Gunna - Speed It Up
GoldLink - U Say feat. Tyler, The Creator & Jay Prince
Lil Baby - Baby Lil Baby feat. DaBaby
Lil Tjay - F.N
Travis Scott - HIGHEST IN THE ROOM
Saba & IDK - Beautiful Smile
Juice WRLD & YoungBoy Never Broke Again - Bandit
YBN Cordae - Broke As Fuck
Mulatto - Bitch From Da Souf
Offset - Clout feat. Cardi B
Future & Doe Boy - 100 Shooters feat. Meek Mill
Ski Mask The Slump God - Faucet Failure
Mustard & Migos - Pure Water
Lil Uzi Vert - Sanguine Paradise
NAV - Tap feat. Meek Mill