Noah Kahan - Forever
USHER - Kissing Strangers
Latto - Sunday Service
Maggie Rogers - Don't Forget Me
d4vd - Leave Her
NLE Choppa - City Lights
Sia & Kylie Minogue - Dance Alone
girl in red - Too Much
Camilo & Evaluna Montaner - PLISüêö
Kid Cudi & Denzel Curry - BLACK OPS
JVKE - lavender
Conan Gray - Lonely Dancers
Shygirl & SG Lewis - mr useless
Michael Marcagi - In The Light
Nate Smith - Bulletproof
Gwen Stefani & Blake Shelton - Purple Irises
Brittany Howard - Power To Undo
Declan McKenna - I Write The News
Artemas - breath away
Nardo Wick - Somethin' (feat. Sexyy Red)
¬•$, Kanye West & Ty Dolla $ign - Talking / Once Again
T-Pain - Dreaming
Zara Larsson - Venus
Emei - Love Me Not
Fuerza Regida - Brillarosa
Victony - Everything
YoungBoy Never Broke Again - Fuck Niggaz
Kaliii - BOZO
Anyma - Pictures of You
HARDY - ROCKSTAR
Mk.gee - Alesis
Aqyila - Bloom
Tori Kelly - high water
Jennifer Lopez - This Is Me‚Ä¶Now
Danny Ocean - AMOR
1999 WRITE THE FUTURE, Amaarae & Warren Hue - cOoL WATeR foR thE nIGHT
Chief Keef & Mike WiLL Made-It - Dirty Nachos
GloRilla - Yeah Glo!
Madison Beer - Make You Mine
Chelsea Wolfe - House Of Self-Undoing
Odd Mob, OMNOM & Hyperbeam - All Day, All Night
jxdn - WHEN THE MUSIC STOPS
Iron & Wine - You Never Know
The Strumbellas - Steal My Soul
Souly Had & The E-Block - cigarettes
Fivio Foreign & Lil Tjay - Trauma
Yung Miami - 50/50
Natalie Jane - Tattoos
Koryn Hawthorne - Love Is U
The Castellows - Cowboy Kind of Love
Madi Diaz - For Months Now
Katelyn Tarver - One Without the Other
Helado Negro - Colores Del Mar
√ìscar Maydon & Marca Registrada - Anda Bien el Nene
Jax Jones & Zoe Wees - Never Be Lonely
Lay Bankz - Tell Ur Girlfriend
Andra Day - Probably
Zolita - Bloodstream
The Decemberists - Burial Ground
Brenn! - Revival
Daisy Grenade - Liquor and Kerosene (feat. The Maine)
DannyLux - CIUDAD DEL SOL
Jay Wheeler - Historia
BabyDrill - ScoreGod (feat. Luh Tyler)
MAX - STUPID IN LOVE (feat. HUH YUNJIN of LE SSERAFIM)
Matoma, Miriam Bryant & Hver gang vi m√∏tes - Samurai Swords
Little Simz - Mood Swings
MICHELLE - ON THE LINE
Em Beihold - Maybe Life Is Good
WanMor - BABY
Kith, Cam'ron & Swizz Beatz - Last Stop
Erika de Casier - ice
Cloonee - To The Beat
Carver Jones & Mckenna Grace - Middle Name
Sam Barber - S.O.B.
Blake Rose - Suddenly Okay
DBN Gogo & Atmos Blaq - UTHANDOüêö
DD Osama - YEH
Monaleo - Show You Sum
Milo j - VITALICIO
San Holo & Au/Ra - GLOW
Bea and her Business - Me Against My Head
AG Club, See You Next Year & ICECOLDBISHOP - How To Cry
Amen Dunes - Purple Land
Higher Power - Absolute Bloom
Ovi & Pailita - Se Cans√≥üêö
KA$HDAMI - Want!
LaRussell, Hit-Boy & Big Hit - ANOTHER ONE
Hailey Knox - Stranger
Loving - Uncanny Valley
ayokay - Naked Love
Icandy - Like This (Back It Up)
JELEEL! - I LOOK GOOD!
Marshmello & HOL! - Movement
Mohamed Ramadan, Future & Massari - ARABI
Alok & Ely Oaks - Tsunami
Dreamer Boy - Heartbreaker
slimdan - Drank on Accutane
Reik - Gracias por Nada