Martin Garrix - No Sleep (feat. Bonn)
Kehlani - Nunya (feat. Dom Kennedy)
Dave - Black
James Bay - Peer Pressure (feat. Julia Michaels)
Tom Walker - Not Giving In
Stefflon Don - Take Off
Duke Dumont - Red Light Green Light - For Club Play Only, Pt. 6
Sundara Karma - Little Smart Houses
Joesef - Limbo
Blithe - Don't Blink
The Pale White - Medicine
Giggs - 187
P!nk - Walk Me Home
slowthai - Peace Of Mind
Rhys Lewis - Hold On To Happiness
Dr Vades - Ringtone
Andy C - Till Dawn
CHARLOTTE - I Tell Lies
Diplo - Mira Mira
Digital Farm Animals - Lookin' For
Steve Aoki - Are You Lonely (feat. ISÁK)
Vistas - Eighteen
David Gray - If 8 Were 9
Maren Morris - The Bones
Circa Waves - Times Won’t Change Me
Giggs - HOLD UP
Bruno Major - Old Fashioned
Krystal Klear - Euphoric Dreams
Kojaque - Flu Shot
Joel Baker - What's A Song
Col3trane - The Fruits
AMA - Slip
Hayden Thorpe - Diviner
Oliver Nelson - Yellow (feat. Liv Dawson)
bülow - Sweet Little Lies
James TW - Suitcase
Jack Gray - Down Side Of Up
FINNEAS - Claudia
Ingrid Andress - Lady Like
Petit Biscuit - Wide Awake
IAMDDB - Give Me Something
Roses Gabor - Feels Roll N Burn
Cosmo Calling - Rita
Julia Jacklin - Don't Know How To Keep Loving You
Jerome Thomas - The 1
Suzi Wu - Error 404
Rival - Lately
Low Steppa - You're My Life
Lil Pump - Be Like Me (feat. Lil Wayne)
MØ - Theme Song (I'm Far Away)
Neil Cowley - Solitary Refinement
Johnny Marr - Armatopia
SPINN - Is There Something That I Missed?
Gunna - Outstanding
Nnic - Grow
ARLO - Changing (feat. Mick Jenkins)
John Mayer - I Guess I Just Feel Like
Aldous Harding - The Barrel - Radio Edit
MJ Cole - Waking Up - VIP Extended Mix
SUB BLUE - Russian Roulette
Rak-Su - Into It
Jaded - Slippin'
Tierra Whack - Only Child
Jack Back - 2000 Freaks Come Out
Adam Lambert - Feel Something
Still Greedy - On My Own
Mollie Collins - Lost & Found
Mathilda Homer - Probably Sorry
Dido - Chances
CLAY - sponge
Will Clarke - Our Love
Benjamin Roustaing - Old Days
Gold Spectacles - Origami Lover
ALEXIS ASHLEY - Saint
Clean Cut Kid - I Don't Like You but I Love You
Freddie Gibbs - Flat Tummy Tea
Tough Love - Echoes
Lauren Daigle - Don't Dream It's Over - Recorded at Sound Stage Studios Nashville
Murlo - Outer Body
Teenage Fanclub - Everything Is Falling Apart
Uffie - No Regrets
Christian Nielsen - Never Been To Detroit
Rose Dive - U&i
((( O ))) - Yuyu
Safe To Swim - Make Things Like They Used to Be
Pinty - Nightcrawler
Gary Clark Jr. - Low Down Rolling Stone
Yola - Still Gone
Wh0 - Mary's Poppin'
Durand Jones & The Indications - Long Way Home
Grace VanderWaal - Stray
Madonnatron - Sucker Punch
Tyla Yaweh - Who Shot Johnny?
Nilüfer Yanya - Tears
Ora the Molecule - Samurai
The Dawdler - Sylvie
Strand of Oaks - Ruby
narou - Oblivious
Ezra Furman - Devils Haircut1