Conrad Sewell - "Precious"
Hannah Grace - "Silver Lining"
Joesef - "Borderline"
The Veils - "Time"
Uncle Murda - "Rap Up 2022"
1/2
MAXINE - "Kinda Wanna"
NewJeans - "OMG"
張蔓莎 (Sabrina Cheung) - "甜蜜在十點五十九分前 (Stay For One More Minute)"
1/3
艾粒 (ILUB) - "仍然未説的 (Never Too Late)"
The Lemon Twigs - "Corner of My Eye"
1/4
洪嘉豪 (Hung Kaho) - "隨波逐流 (Following the Crowd)"
Skrillex, Fred again..., Flowdan & Elley Duhé - "Rumble"
YoungBoy Never Broke Again - "Black"
YoungBoy Never Broke Again - "Groovy"
YoungBoy Never Broke Again - "I Love YB skit"
YoungBoy Never Broke Again - "Top Girls"
1/5
Dani Torres - "Inevitable"
Daughtry - "Separate Ways (Worlds Apart)" ft. Lzzy Hale
Davina Michelle - "Heartbeat"
Kaydy Cain & La Promesa Rd - "Detrás Del F"
Kevin Roldán, Almighty & HIT$ Music - "Tu Silueta"
Lil Darius - "Neighborhood Trapstars" ft. Peezy
Marcianeke & Jairo Vera - "Dime"
Milly - "Antes De"
Natalie Perez - "Consuelo"
Raissa - "I Want Your Sex"
Sasha Wrist - "Taboo"
Shania Twain - "Giddy Up!"
Soledad & Los Palmeras - "Tu Marca"
1/6
Abraham Mateo - "La Idea"
AK - "2 a.m. In a City You Can't Get To"
Alejandro Fernández - "Inexperto en Olvidarte"
Anthem Lights - "Wherever I Go"
Armin Van Buuren & Matoma - "Easy To Love" ft. Teddy Swims
Ava Max - "Million Dollar Baby (Nathan Dawe Remix)"
BiC Fizzle - "Check" ft. Big Yavo
Busy Signal - "New Year"
Cheat Codes & Dolly Parton - "Bets On Us"
David Guetta & Bebe Rexha - "I'm Good (Blue) [Acoustic]"
Dennis Lloyd - "Today, Tomorrow"
Elle King - "Tulsa"
FEYZAL - "Need For Speed"
Groundbreaking - "Crowns"
INNA & Stefflon Don - "Yummy"
Joel Corry & Tom Grennan - "Lionheart (Strings Version)"
Lauren Cimorelli - "All In My Head"
Lefty SM & Tornillo - "Ingrata"
Leony - "Somewhere in Between"
Lewis Capaldi - "Pointless (Piano Acoustic)"
Lil Kee - "Gang Shit"
LIil PJ & Ronny J - "Can't Run Away"
Lola Indigo & Luis Fonsi - "CORAZONES ROTOS"
Majestic & Karen Harding - "Sweat"
Marki - "​beso francés"
McKenna Grace - "Ugly Crier"
Monsieur Nov - "Love Therapy"
NERIAH - "Puppet On A String"
Omar Rudberg & Claudia Neuser - "Call Me By Your Name"
Owl City - "Kelly Time"
Peter Gabriel - "Panopticom (Bright-Side Mix)"
Popcaan & Drake - "We Caa Done"
Quavo - "Without You"
Queen Naija - "Let's Talk About It"
Rafa Pabön - "Agüita de Coco"
Renzo Go Rellah - "Buenas Y Malas"
RHODES - "Good to You"
Rhys Lewis - "To Be Alive"
RichyRanger - “Feel Like A Jungle”
Ruben - "I'm Sure He Loves You"
Russ - "PUT YOU ON GAME"
Seafret - "See, I'm Sorry"
Sigala & MNEK - "Radio"
Skinny Flex - "No Fallo"
Skrillex - "Way Back" ft. PinkPantheress & Trippie Redd
Steve Aoki, Regard & mazie - "New York"
Stormzy - "Hide & Seek (FLO Remix)" ft. FLO
SYML - "Believer"
Thomas Rhett - "Half Of Me" ft. Riley Green
Tiësto - "Lay Low"
Tyler Hubbard - "Me For Me"
Valiant - "Weh She Love"
VEDO & Chris Brown - "Do You Mind"
Ward Thomas - "All Over Again"
Yahritza Y Su Esencia - "Cambiaste"
1/7
Jara 909, Christian Doncic & Kanon Blvck - "Glow Up"
Li Rye - "FACESHOT" ft. Sett
oxxie - "CUT IT"
1/8
Albere - "Una Copa"
1/9
Babi - "De frente"
Belle and Sebastian - "I Don't Know What You See In Me"
Blessed013 & Adriz Madrid - "ELLA"
Daughter - "Be On Your Way"
陳奕迅 (Eason Chan) - "盲婚啞嫁 (Blind Marriage)"
Tayc - "Carry Me"
Ulrikke - "Honestly"
Wesley Joseph - "HIATUS"
Young Fathers - "Rice"
1/10
Al Safir - "Geishas"
Dan Croll - "Slip Away"
Everything But The Girl - "Nothing Left To Lose"
Julia Wolf - "Rookie of The Year"
Kate Bollinger - "J'aime Les Filles"
Kate Davis - "Monster Mash"
M83 - "Oceans Niagara"
M.E.D - "Not Cry"
Nicole Favre - "Tranqui"
ROBI - "Tu Mundo"
SG Lewis, Charlotte Day Wilson & Channel Tres - "Fever Dreamer"
shame - "Six-Pack"
Spacey Jane - "Lots of Nothing" ft. BENEE
Tennis - "Let's Make a Mistake Tonight"
U.S. Girls - "Futures Bet"
Vistas - "One More Night With No One"
Rack - OXI
1/11
​​‎alequi, María Escarmiento & detunedfreq - "una confesión"
Andrew Garden - "one more dance"
Beenie Man - "Mankind"
Benny Sings - "Young Hearts"
Bizarrap & Shakira - "Shakira: Bzrp Music Sessions, Vol. 53"
Chiiild & Lucky Daye - "Good For Now"
Davy One - "Bloqué"
Malik Baptiste - "All You Need To Know ft. Snoh Aalegra
Matilda Mann - "Borderline Insane" ft. spill tab
Matt Corby - "Reelin'"
Nick Carter - "Hurts to Love You"
poptropicaslutz! - "Sierra Echo X-Ray"
Rusherking - "Fondo de Pantalla"
Sam Smith, Koffee & Jessie Reyez - "Gimme"
Sophia Bel - "No Sleep"
Sophia Scott - "Her"
Soulja Boy - "Big Bossed Up"
The Jordan - "Temptation"
1/12
Ava Max - "One of Us"
Aya Nakamura - "Baby"
Chesca & Dalex - "Easy"
COLLAR - "The Bright Side"
ECKO & Kaleb Di Masi - "Pal Party"
FMK - "La Gira" ft. Rei
Freya Ridings - "Weekends"
Gareth.T - "孤單 (Lonely)"
李幸倪 (Gin Lee) - "Dum Dum"
Hamza - "Introduction"
Imanbek, Crazy Donkey & brando - "Fake" ft. Paradigm
Indy Yelich - "Hometown"
Justin Quiles & Myke Towers - "Whiskey y Coco"
Katie Melua - "Golden Record"
Keira - "No Business On The Dancefloor"
King Savagge - "NOPALATELE" ft. AK4:20, Paloma Mami
Kinneret - "Soon You're Gonna Know" ft. Dev Lemons
​koi - "no wonder"
Lasso - "Plástico"
Ledisi - "I Need To Know"
LIT killah - "Neón"
Lonely Cortell - "forget me not"
María Becerra - "DESAFIANDO EL DESTINO"
MAY-A - "Sweat You Out My System"
Miss Grit - "Lain (phone clone)"
Ozuna & YOVNGCHIMI - "Quien Va a Frontiar"
陳蕾 (Panther Chan) - "窮人的薔薇 (Poor Man's Rose)"
Paramore - "C'est Comme Ça"
Royel Otis - "I Wanna Dance With You"
Tiago PZK - "Bemaste"
TINI, La Joaqui & Steve Aoki - "Muñecas"
Vagabon - "Carpenter"
Valley - "Throwback Tears"
Whyte Fang - "Transport God"
1/13
Alle Farben - "I Need to Know" ft. Flynn
All Time Low - "Tell Me I'm Alive"
Alok & James Arthur - "Work With My Love"
American Authors - "Best Night of My Life"
Andy Grammer - "These Tears"
Arian Cruz & ShonMC - "Fresh Start"
AViVA - "PRESSURE"
Bea Miller - "lonely bitch"
BIGBABYGUCCI - "Bank Account"
Billy Lockett - "Miss Missing You"
Caity Baser - "2020s"
Call Me Loop - "Walls"
Cartel de Santa - "Piensa en Mi"
Cash Cash - "Anyway" ft. RuthAnne
CG5 & Dagames - "Children of the Machine"
Chalynn - "Luv Sum U"
Chris Young - "All Dogs Go To Heaven"
Chris Young - "Looking For You"
Dash Berlin, DubVision & Emma Hewitt - "Time After Time (Acoustic Mix)"
De La Ghetto, Luar La L & YOVNGCHIMI - "Los Palos"
Derin Falana - "Good Problems"
Dierks Bentley - "Same Ol' Me"
Diplo - "Wasted" ft. Kodak Black & Koe Wetzel
Dreamer Isioma - "Fuck Tha World"
Eagle-Eye Cherry - "Thinking About You"
Ella Vos - "Mindreader"
Elli Ingram - "Growing Pains"
Fuego, Roy Woods & Polimá Westcoast - "Luces"
GANG51E JUNE - "Kisses 2 The Sky"
gavn! - "hit the dirt"
Genevieve Stokes - "17"
Gracie Abrams - "Where do we go now?"
Grupo Marca Registrada & Fuerza Regida - "El Pickles"
Gucci Mane & Kodak Black - "King Snipe"
​hemlocke springs - "stranger danger!"
Iravera - "Feathers & Bones"
Iris - "Ahora"
‌iZaak - "Qué casualidad"
Jason Derulo - "Whatcha Say (Sped Up)"
JAWNY - "true"
J.I the Prince of N.Y - "It's Officially Done"
jenny nuo - "​recruitment season"
JESSIA - "Nobody Hates You"
Jessie Murph - "About You"
Joel Corry & Tom Grennan - "Lionheart (FAST BOY Remix)"
Jossef & Kevin Roldán - "Clickiamos"
KELZ - "Good 2 Me"
Laura Roy - "Breathe"
Lauren Cimorelli - "Ended Up In Arkansas"
​Lennixx - "Contemplate"
Lil Zay Osama - "Glah Glah Pt. 2"
Logan Michael - "Another Go"
Logic - "Wake Up" ft. Lucy Rose
Lukas Graham & Mickey Guyton - "Home Movies"
Måneskin - "GOSSIP" ft. Tom Morello
Marshmello & Jamie Brown - "Party Jumpin'"
Martin Jensen & Jay Sean - "Days Like This"
MICHAELA - "Last One You Love"
Mike Williams & Tungevaag - "Dreams Come True"
Miley Cyrus - "Flowers"
Mimi Webb - "Red Flags"
Mokita - "I Can't Help Myself"
Nathan Dawe, Star.One & D Double E - "Sweet Lies (Star.One Remix)". ft Talia Mar, Queen Millz & Ashley Walters
Nessly, DËKAY, Ally Brooke & 1da Banton - "High Fashion Drugs (Remix)"
Noa Kirel - "Gone"
PARTYNEXTDOOR - "Her Old Friends"
Prentiss & skaiwater - "​so easily"
Quinn XCII - "The Lows"
Raaban, Jonas Wallin & Vigiland - "Island"
RealestK - "Wish You Well"
Rezz, Quackson & Wreckno - "Gyrate"
Robinson - "Oblivion"
Roo Panes - "Our Time"
Sam Feldt & Cate Downey - "Enough To Drink"
Showtek & Eday - "Everybody"
Switch Disco - "REACT" ft. Ella Henderson & Robert Miles
TAEYANG - "VIBE" ft. Jimin
The Chainsmokers & Cheyenne Giles - "Make Me Feel"
Tom Speight - "The One"
Tornillo & Homer el Mero Mero - "Belico"
Thitis, Dj Scumvag - "Pleonektes"
Yandel & Wisin - "Te Gusta"
You Me At Six - ":mydopamine:"
Yung Pinch - "Paid My Dues"
1/14
Kali - " Dangerous (Freestyle)"
Now United - "Odo"
1/15
EOS - "BIG BANG"
1/16
CMAT - "Mayday"
鄭欣宜 (Joyce Cheng) - "仍會等 (I'll Still Be Waiting)"
M.E.D - "Breaking Ur Heart"
Robin Packalen - "Girls Like You"
Skeng - "Full Moon"
Triple G - "時間計 (Tik Tak)"
1/17
Fenne Lily - "Lights Light Up"
Hozwal & Alejo - "Decline"
Kelela - "Contact"
Lxandra - "Something To Lose"
M.E.D - "I Don't Like You"
Noel Gallagher's High Flying Birds - "Easy Now"
Rose Gray - "Sun Comes Up"
Voda Fuji - "Mismatch"
Yaeji - "For Granted"
岑寧兒 (Yoyo Sham) - "一個人走走 (Walking Alone)"
1/18
A$AP Rocky - "SAME PROBLEMS?"
Arlo Parks - "Weightless"
Billie Marten - "This Is How We Move"
Black Honey - "Up Against It"
​boygenius - "$20"
​boygenius - "Emily, I'm Sorry"
​boygenius - "True Blue"
Boys World - "Mantrum"
Dizzy - "Birthmark"
DMA'S - "Fading Like a Picture"
Fall Out Boy - "Love From The Other Side"
Gloria Groove - "PROIBIDONA" ft. Anitta, Valesca Popozuda
Gloss Up & GloRilla - "Bestfrenn"
Gretel Hänlyn - "Wiggy"
陳卓賢 (Ian Chan) - "再見 寧靜海 (Sea of Tranquility)"
Maple Glider - "You're Still the One"
MC 張天賦 (Cheung Tinfu) - "世一 (The One For U)"
Rebecca Black - "Sick To My Stomach"
Skrillex & Bobby Raps - "Leave Me Like This"
The National - "Tropic Morning News"
TLE Cinco - "I'm Back"
Vita Flare - "LONG NIGHTS <3"
Vita Flare - "USED TO"
Wednesday - "Chosen to Deserve"
Yellow Days - "Soul Smile"
Zolita - "Ashley"
1/19
Abdiel - "Polos"
Alison Goldfrapp & Claptone - "Digging Deeper"
Becky Hill - "Heaven"
Brytiago - "Mi Vicio"
Caroline Rose - "Miami"
Cub Sport - "Keep Me Safe"
Dei V - "Trending"
Dolly Parton - "Don't Make Me Have to Come Down There"
Ed Sheeran - "F64"
Jotaerre - "GALAXIA" ft. Chris Palace
Kali Uchis - "I Wish you Roses"
Låpsley - "Lifeline"
Leslie Shaw - "Piscis"
Lil Darius - "Rubi Wayda" ft. Luh Tyler
Lil Tjay - "Clutchin My Strap"
LUANA, Seven Kayne & Luck Ra - "Será Mi Culpa? (Remix)" ft. Lautaro Lopez
M.E.D - ["like a liar"] (https://genius.com/Maemd-like-a-liar-lyrics)
Miranda! & Lali - "Yo Te Diré"
Nicky Jam - "Toy A Mil"
Nio García - "Yeska"
OG Notaloka & El Virtual - "G-Auchito Code"
Reiley - "Breaking My Heart"
Ryan Castro - "Ghetto Star"
Sett - "Take Down"
Standly, El Barto & Blessd - "Mi Gata (Remix)"
The Kid LAROI - "I Can't Go Back To The Way It Was (Intro)"
The Tyne - "(NOT A) LOVE SONG" ft. NOAHFINNCE
TIMØ - "ENERO"
VÉRITÉ - "temporary"
1/20
Adexe & Nau - "Llorarte un río"
Afrojack & R3HAB - "Worlds On Fire (Afrojack & R3HAB vs Vion Konger VIP Remix)" ft. Au/Ra
AK - "Classic"
Ana Mena - "Un Clásico"
Andy Rivera - "No Pinto Pajaritos"
Brevin Kim - "ShoulderBlades"
Cheat Codes & Mitchell Tenpenny - "What's It Gonna Take"
CJ - "Gangsta"
Conor Maynard - "If I Ever"
Darkiel & Maffio - "Hoy"
Dolly Parton, Belinda Carlisle & Cyndi Lauper - "Gonna Be You" ft. Gloria Estefan & Debbie Harry
Elley Duhé & Whethan - "MONEY ON THE DASH"
Ely Blancarte - "Teikirisi"
Fedde Le Grand, Melo.Kids & Mila Falls - "I Used To Think"
Frank Walker - "I Go Dancing" ft. Ella Henderson
Gonzy - "ODISEA"
ILLENIUM - "Luv Me A Little" ft. Nina Nesbitt
JD Pantoja - "Como Tú"
Julianno Sosa, Ñengo Flow & Ryan Castro - "Cochinae (Remix)" ft. King Savagge
Jordan Davis - "No Time Soon"
Kim Petras - "brrr"
Kygo, Gryffin & Calum Scott - "Woke Up In Love (Acoustic)"
Lauren Cimorelli - "I Hate All Your Friends"
Lenay - playa en enero
M2H - "Fin del Mundo"
Macklemore - "HEROES" ft. DJ Premier
M.E.D - ["Marry Him"]  (https://genius.com/Maemd-marry-him-feat-kimira-lyrics)
Meghan Patrick - "She’s No Good for Me"
Morat & Camila Fernández - "Debí Suponerlo (Versión Mariachi)"
Morgan Page & Skylar Grey - "Partly Cloudy"
NLE Choppa - "23"
Oliver Heldens & Karen Harding - "Oops"
otuka - "potent"
Peter Gabriel - "Panopticom (Dark-Side Mix)"
Picture This - "Get On My Love"
Pitbull, AYYBO & ero808 - "RIGHT OR WRONG (HYPNOSIS)"
Roberta Flack - "Killing Me Softly With His Song (DJ Spinna Remix)"
Sam Smith - "Gloria"
Sammy Rae & The Friends - "Closer to You"
Say Lou Lou - "Waiting for a Boy"
Shawn Christmas - "Seishun Complex"
Thomas Rhett - "Angels"
TWICE - "MOONLIGHT SUNRISE"
Vybz Kartel - "Hope is a Liar"
1/21
CG5 - "DEATH"
Will Ryan - "Living Life Without the Cord"
YoungQueenz - "‎söng of songs"
1/23
XXXTENTACION & Lil Uzi Vert - "I'm Not Human"
1/24
Ava Max - "Cold As Ice"
BiC Fizzle - "Get Down Gang" ft. Li Rye
Big Boogie - "Twelve Four"
Fivio Foreign - "Notice Me" ft. Tata, Jenn Carter & Kyle Richh
Jordan Ward & Ryan Trey - "WHITE CROCS"
Kimbra - "foolish thinking" ft. Ryan Lott
Rich Brian - "Sundance Freestyle"
Samia - "Breathing Song"
Samia - "Honey"
Soulja Boy - "No Price Tag"
Yelle - "Top Fan"
Yves Tumor - "Echolalia"
1/25
Aly & AJ - "Baby Lay Your Head Down"
Ann Marie - "Back 2 the Streets"
Cordae - "Two Tens" ft. Anderson .Paak
Daisy Jones & The Six - "Regret Me"
Fall Out Boy - "Heartbreak Feels So Good"
Fever Ray - "Kandy"
​joan - "nervous"
JOSEPH - "Nervous System"
KATO2X - "Havin Now"
Kaze - "El Chico de la Ropa de Colores"
Leyla Blue - "Late Night"
Ruel - "MUST BE NICE"
slowthai - "Selfish"
Stephen Sanchez - "Evangeline"
Teejay - "Visa"
Zeina - "Whatever"
1/26
Arcángel - "Kame Hame"
bosco herrero - "JE T'AIME À MOURIR 2"
Christian Nodal & TINI - "Por el Resto de Tu Vida"
Daviles de Novelda & Abraham Mateo - "Te Miro a La Cara"
Kian Kova - "Hello Kitty"
Mozzy - "Every Night" ft. Baby Money
Paty B - "ALÉRGICA"
PVRIS - "GODDESS"
RNS, ONYX - "Acropolis"
Zara Larsson - "Can't Tame Her"
1/27
Adam Lambert - "Getting Older"
Aidonia - "Faith"
Alexander 23 - "How To Drive"
Anson Seabra - "I Can Love Anyone (As Long As It's You)"
Armin van Buuren - "Dayglow" ft. Stuart Crichton
Black Birdie - "maybe, i'm the problem" & "idfk"
Bobby Shmurda - "Rats"
Breathe Carolina & ManyFew - "Dancing In The Dark (Radio Edit)"
Burak Yeter & Avalan - "Don't Speak (Radio Edit)"
Call Me Karizma - "Down" ft. AViVA
​charlieonnafriday - "That's What I Get"
CHASE WRIGHT - "Never Loved Before"
Chlöe - "Pray It Away"
Colton Dixon - "Build a Boat (Remix)" ft. Gabby Barrett
Dimitri Vegas & Steve Aoki - "The White Lotus Theme (Aloha)"
Eric Bellinger - "Decide"
EST Gee - "BLOW UP"
EST Gee - "IF I STOP NOW"
Eugy Official - "Naughty"
Fleur East - "Count the Ways"
Flo Milli - "Conceited (Remix)" ft. Lola Brooke & Maiya The Don
Fueled by 808, Kid Rock & Austin Mahone - "No Limits" ft. Jimmie Allen
Gorillaz - "Silent Running" ft. Adeleye Omotayo
INNA & Dhurata Dora - "Yummy"
INNA, Dhurata Dora & Stefflon Don - "Yummy"
Immasoul - "A Tu Lado"
Jake Owen - "My Boots Miss Yours"
Jodie Harsh - "Hectic"
KayCyy - "MOTOWN" ft. BabyTron
Kerli - "21st Century Kids"
KSI - "Voices" ft. Oliver Tree
Las Villa & Llane - "Bendita"
Lauren Cimorelli - "R.I.P."
Luke Combs - "Growin' Up and Gettin' Old"
Maisie Peters - "Body Better"
Martin Jensen & Jay Sean - "Days Like This (VIZE Remix)"
​​Maurice Moore - "dgaf."
Meghan Trainor - "Made You Look (Instrumental)"
Meghan Trainor - "Made You Look (Remix)" ft. Kim Petras
Meghan Trainor - "Made You Look (Sped Up Version)"
Monsieur Nov - "Dernier je t'aime" ft. Josman
Neek Bucks - "RED LIGHT"
New Hope Club - "Don't Go Wasting Time"
Oliver Buckland - "anemoia"
P!nk - "TRUSTFALL"
Q - "LUV (I KNOW I WANT THIS FOR REAL)"
R3HAB & Afrojack - "Shockwave"
Rae Sremmurd - "Sucka Or Sum"
Ray Vaughn & Ab-Soul - "Sandcastles"
Rita Ora - "You Only Love Me"
ROSALÍA - "LLYLM"
鄭秀文 (Sammi Cheng) - "我這樣活了一天 (Lost Love)"
Sigala & MNEK - "Radio (Extended)"
Skott - "Hail Mary"
Soulja Boy - "Wassup Twin"
Steele 11 - "City of God"
The Kid LAROI - "Love Again"
Tom Grennan - "Here"
Tom Odell & AURORA - "Butterflies"
Toosii - "Magic Potion"
VIC MENSA - "STRAWBERRY LOUIS VUITTON" ft. Thundercat & Maeta
​​Wrabel - "happier"
1/30
AMBKOR & Nach - "Dime"
The Hertz - "命之道 (Ways of Life)"
1/31
Caroline Polachek - "Blood and Butter"
tuv - "run"1