Del Mar - Ozuna
Lithuania (feat. Travis Scott) - Big Sean
Inhale -Bryson Tiller
Callin (feat. Snoop Dogg) - YoungBoy Never Broke Again
Sweet & Sour (feat. Lauv & Tyga) - Jawsh 685
What They'll Say About Us - FINNEAS
OMG What's Happening - Ava Max
Vroom Vroom - A Boogie Wit da Hoodie
The Voice - Lil Durk
Baggin' - Marshmello
Tap In (feat. Post Malone, DaBaby & Jack Harlow) - Saweetie
The One - FLETCHER
Medicine - Gus Dapperton
Trenches - Monica
Too Blessed - Rich The Kid
Freckles - Curtis Waters
Bottom of the Bottle - Jack Kays
Not Enough - Pritty
yup! - Yung Gravy
Down (feat. Mulatto) - G-Eazy
Obey (with YUNGBLUD) - Bring Me The Horizon
Island - Bow Anderson
Come Over - VanJess
Fall Slowly - Joyner Lucas
Between Our Hearts (feat. CXLOE) - Cheat Codes
What Do You Think Of? - Lauren Alaina
Do It (feat. Doja Cat, City Girls & Mulatto) [Remix] - Chloe x Halle
EURO PLUG - Tony Velour
Se Te Nota (with Guaynaa) - Lele Pons
Messy - Lil Tracy
LOCKED UP 2 - 6ix9ine
Invisible - Yuna
A Little Bit Yours - JP Saxe
Tuethday - Deaton Chris Anthony
Lasting Lover - Sigala
Bummerland - AJR
Red Gatorade - Audrey Mika
Glitch (feat. Tinashe) - Buddy
Endorphins - tobi lou
Hurt - Lost Kings
arsenic - glaive
Walking Flames - Actress
RE(a)D (with Bas) - Dua Saleh
Death Is Callin - Mozzy
High School Dropout - Lil Loaded
Echalo Pa' Ca - Sofia Reyes
Tiger Inside - SuperM
Fire - Ytram
Peddle Bike - Mishaal
Unreal - Julia Stone
Somebody Else - Navvy
Next Girl - Carly Pearce
Working For The Weekend (feat. bbno$) - MAX
Good Vibes - HRVY
TRUCK - HARDY
Rapture - Declan McKenna
Paraphernalia - Temples
If You Want Me To Stay (with Anthony Ramos) - Ari Lennox
It's OK To Be Black 2.0 (with D Smoke & Buddy) - Jac Ross
Push Start - Toosii
Running Away (feat. Devault & Seb Torgus) - GASHI
Pretty Please - Jackson Wang
i remember - Sky McCreery
Where Did Our Summer Go? - Tony Ferrari
Puddles - Daniela Andrade
Hold On Tight - Aloe Blacc
B.R.A.T. (feat. Blac Youngsta) - LightSkinKeisha
Destiny's Song - Phora
MODEL - prettyboys
Allen Street - Pretty Sick
It’s Only A Heartbreak - Dagny
More Love - Sara Bareilles
Thinking - ELLIANA
Better Than This - Paloma Faith
FREAK - Shygirl
GMFU - Sally Sossa
Sittin In My Car (feat. Fabolous & A Boogie Wit da Hoodie) - DJ Envy
All Luv - Angelo Mota
ZZZ's - B.o.B
Lancaster Nights - Charlie Burg
Campfire - Kevin Morby
If We're Being Honest - Novo Amor
Paradise Found - Eden xo
Lois - Scott Helman
Still Love You - Tyler Rich
Don’t Approach Me (feat. OMB Peezy) - Big Havi
Admit It - Bktherula
No Love Lost - Blxst
Little Did I Know - Sofía Valdés
CHAOS - Gia Woods
B.O.M.B. - At. Panther
Blow It All - YSN Flow
On Me - Tay Money
Waste - Joe Avio
Bite - Aaron Carpenter
One Day Left - LOVA
Strange Days (with Robbie Williams) - The Struts
Okay Doeee - Rucci