Anuel AA & YOVNGCHIMI - "Diamantes en Mis Dientes"
Ellie Goulding - "Fields Of Gold"
ToNick & KOLOR - "無雙 (ONE)"
張蔓莎 (Sabrina Cheung) - "自生自滅 (Self-perpetuating)"
Samia & papa mbye - "Mad at Me"
Tusse - "I Wanna Be Someone Who's Loved"
Years & Years - "100% Pure Love"
11/2
21 Lil Harold - "Robbin Season"
Aly & AJ - "With Love From"
FN DaDealer - "OK" ft. Rylo Rodriquez
Jenni Rivera - "Misión Cumplida"
Lucius - "Muse"
吳林峰 (Ng Lam Fung) - "俄羅斯套娃 (Russian Doll)"
Ninajirachi - "Crush Me" ft. Kota Banks
Sleepy Hallow - "Marie"
Yves Tumor - "God Is a Circle"
Zpecial - "Not the One (Neither of Us)"
11/3
A Boogie wit da Hoodie - "Ballin"
Avril Lavigne - "I'm a Mеss" ft. YUNGBLUD
Chris Jedi, Anuel AA & Gaby Music - "DURO" ft. Jenny "La Sеxy Voz"
DEREK - "Classe Executiva"
Fredo - "I'm Back"
K-Trap - "Warm (Remix)" ft. Skepta
Mont - "MANIAKA"
NoCap - "DNA"
Paulo Londra & Feid - "A Veces"
P!nk - "Never Gonna Not Dance Again (Sam Feldt Remix)"
Ryan Castro, DJ Luian & Mambo Kingz - "Nadie Nos Vio"
Scribz Riley - "Satisfied"
Selena Gomez - "My Mind & Me"
SG Lewis - "Lifetime"
Tiësto & Tate McRae - "10:35"
11/4
Alan Walker & Sophie Simmons - "Lovesick"
Alemán - "Grillz" ft. NICKI NICOLE
Anson Seabra - "Hard To Be Human"
Aqyila - "OH!"
AWOLNATION - "We Are All Insane"
Bishop Briggs - "Cheer"
Big Yavo - "Whole Lotta Money"
BK, Chesca & Lennis Rodriguez - "UN BAILECITO"
boyband - "MR. DREAMER"
BROCKHAMPTON - "Big Pussy"
Brynn Cartelli - "Convertible in the Rain"
Camila Cabello - "I'll Be Home For Christmas"
Carlie Hanson - "Illusion"
Ciara & Summer Walker - "Better Thangs (Remix)" ft. GloRilla
Dan + Shay - "Holiday Party"
Darin - "Satisfaction"
De La Ghetto - "Hacerte De To'"
DJ Snake - "Nightbird"
Elton John & Britney Spears - "Hold Me Closer (Pink Panda Remix)"
FLETCHER - "Suckerpunch"
Gorillaz - "Baby Queen"
Jacquees - "Still That"
Jason Aldean - "Christmas In Dixie"
Jason Derulo & Shouse - "Never Let You Go"
Jenevieve - "Christmas Special"
John Legend & Sebastián Yatra - "Nervous (Remix)"
Jonas Blue & Louisa Johnson - "Always Be There (Acoustic)"
JYDN HILL - "Regrets"
Kaiser Chiefs - "How 2 Dance"
Lil Peep - "flannel"
Lil PJ - "Same N*gga"
Lindsay Lohan - "Jingle Bell Rock"
Luke Bryan - "Prayin' In A Deer Stand"
Lul Bob - "Gotta Keep Movin"
Masego - "Say You Want Me"
NLE Choppa - "Ice Spice"
Noelys - "Ciao Adios Goodbye"
Olivia O'Brien - "Never Be The One"
Olly Murs - "Die Of A Broken Heart (Acoustic)"
P!nk - "Never Gonna Not Dance Again"
PLAZA - "Voodoo II"
Q - "Today"
Quevedo - "Punto G"
​quinnie - "itch"
Regard & Drop G - "No Love For You"
Rels B - "pa quererte"
Rileyy Lanez - "Can't Deny"
Sam Fischer - "Carry It Well"
Sam Ryder - "All The Way Over"
Sam Smith & Kim Petras - "Unholy (Orchestral Version)"
Shania Twain - "Man! I Feel Like A Woman! (Real Hypha Remix)"
SpotEmGottem - "Block Got Hot"
Stephen Sanchez & Ashe - "Missing You"
Thalía - "Psycho B**ch"
Transviolet - "Hot AF" ft. Robert DeLong
TroyBoi - "Carti"
Two Friends & Bryce Vine - "Graduated"
Unlike Pluto - "Sinking Sand"
Vanessa Tha Finessa - "Bad Bitch Steppin’"
Victoria Nadine - "Nerve"
Whyte Fang - "Girl"
Zach Zoya - "Birthday Sex"
Zach Zoya - "Come By Here"
11/7
Black Honey - "Heavy"
Cole Swindell & Jo Dee Messina - "She Had Me At Heads Carolina (Remix)"
黃明德 (Dark Wong) - "Don't think too much?"
Jordana - "You're in the Way"
Ka$ey - "Thegoatpart2"
Taylor Swift - "Anti-Hero (Remix)" ft. Bleachers

11/8
ASHWARYA - "Best Friend"
C.R.O & LIT killah - "Mi Culpa"
呂爵安 (Edan Lui) - "攀上天梯的螞蟻 (Ants Climbing the Stairway to Heaven)"
GloRilla - "Nut Quick"
Kate Davis - "Consequences"
古巨基 & 黃明德 (Leo Ku & Dark Wong) - "一刻永恆 (A Moment Forever)"
藍奕邦 (Pong Nan) - "圍牆倒下前 (Before the Wall Comes Down)"
Valiant - "Dunce Cheque"
11/9
Chiiild - "Bon Voyage"
Current Joys - "Cooking"
Hatchie - "Nosedive"
Loïc Nottet - "Mélodrame"
Louis Tomlinson - "Silver Tongues"
Sega Bodega - "Kepko"
Thomas Headon - "Georgia"
11/10
Alejo - "Máscara"
Alexis y Fido & Yomo - "Bellaco"
Ava Max - "Weapons"
​carpetgarden - "lonely"
Channel Tres - "6am"
Enchanting - "Keep it Playa"
Fever Ray - "Carbon Dioxide"
Foogiano - "Body 4 Body"
孫曉賢 (Kendy Suen) - ["在天空挖一個洞 (Portal)"]
Gucci Mane - "Shit Crazy (Remix)" ft. BIG30, Sett & Mac Critter
Lali - "MOTIVEISHON"
Liza - "I Lost a Friend"
Liza - "Room"
Nathy Peluso - "ESTÁS BUENÍSIMO"
Pablo Alborán & María Becerra - "Amigos"
PEDRO SAMPAIO & Pabllo Vittar - "SAL"
RAAHiiM - "Spin the Block"
Sofía Reyes - "Luna"
Taylor Swift - "Anti-Hero (Acoustic Version)"
The Veils - "Undertow"
Ventino - "Cosas Pendientes"
Walker Hayes - "Face In The Crowd"
11/11
Afrojack & James Arthur - "Lose You"
Ally Rendall - "What Even Is Life"
Ally Salort - "Nostalgic"
Andie Case & Alex Goot - "Beautiful (Acoustic)"
Andy Grammer - "Good In Me"
Anne-Marie - "Psycho (Acoustic)"
盧瀚霆 (Anson Lo) - "永順街39號 (39 Wing Shun Street)"
Armin van Buuren & Azteck - "Tocando El Sol"
ASHA - "Ciao, Ciao"
ASTN - "Be So Cruel"
Ashton Travis - "Omw"
Beach Weather - "Trouble With This Bed"
Behani - "Real Man" ft. Ne-Yo
Big Yavo - "Them O Days"
Billy Ray Cyrus & Firerose - "Time"
BROCKHAMPTON - "The Ending"
Chelsea Cutler - "Men on the Moon"
Chris Stapleton - "I'm A Ram"
David Foster & Katharine McPhee - "Blue Christmas"
Dougie B, B-Lovee & Cordae - "Spinnin"
Era Istrefi - "5AM" ft. Buta
Ewan Mainwood - "Leave Me Lonely"
Finesse2Tymes - "Summo"
Fivio Foreign & Rvssian - "1 On 3"
French Montana - "Yes I Do"
Galantis, David Guetta & MNEK - "Damn (You've Got Me Saying)"
Ingrid Michaelson & A Great Big World - "It's Almost Christmas"
王菀之 (Ivana Wong) & Serrini - "誅神的黃昏 (Ragnarök)"
Jenna Raine - "Rent Free"
Joe Jonas & Khalid - "Not Alone"
Jordan Davis - "Part of It"
Jordin Sparks - "Stop This Feeling"
Julia Michaels - "Sorry To Me Too"
jxdn - "Sober"
K. comedy, Key Glock & Mak Sauce - "HYWTB (Hit You With The Blick)"
Kim Petras - "If Jesus Was a Rockstar"
Kygo - "The Way We Were" ft. Plested
Kx5 - "Avalanche" ft. James French
Låpsley - "Hotel Corridors"
Lil Tjay - "Give You What You Want"
Mahalia - "Bag of You"
Patrick Wolf - "Enter the Day"
RichyRanger, RJ Banz - “Like A Jungle”
Rob49 - "Product of the Trenches"
SASH - "Lemon Sorbet"
SIDEPIECE - "Reborn"
Sigala, Gabry Ponte & Alex Gaudino - "Rely On Me"
Slatt Zy - "Life Is Crazy"
Stefflon Don - "The One"
Stormzy - "Firebabe"
Tate228 - "Copies"
The Blessed Madonna - "Serotonin Moonbeams"
Villano Antillano - "Cáscara de Coco"
wifisfuneral - "Obstacles"
Xavier Mayne, Chase Atlantic & ELIO - "FOR HER"
Zakhar & JAE5 - "Devil’s Enemy"
Zyanna & Leaf Ward - "Secret"
11/13
KAROL G - "CAIRO"
11/14
Now United & Noah Urrea - "Good Intentions"
Rebecca Black - "Crumbs"
Rich The Kid - "Motion"
Roddy Ricch - "Twin" ft. Lil Durk
Romy & Fred again.. - "Strong"
Tkay Maidza - "Nights In December"
11/15
Cigarettes After Sex - "Pistol"
Gucci Mane - "Letter to Takeoff"
Kelela - "On the Run"
Nickelback - "High Time"
​per se - "通心術 (The Forgiven)"
PinkPantheress - "Do you miss me?"
Popcaan - "One Way"
Rozzi - "Hand In My Pocket"
shame - "Fingers of Steel"
Tennis - "One Night with the Valet"
Tokischa & Natanael Cano - "Kilos de Amor"
11/16
bbno$ - "​help herself (dnb remix)"
bbno$ - "​feel good inc (bbno$ re-finessed)"
Bizzy Banks - "No Passes"
boyband - "BEEMO!" ft. Big Baby Scumbag
BVDLVD - "TABLE CLOTH" ft. Biv
Charlie Hickey - "A Long December"
Cautious Clay - "Lip Service"
陳奕迅 (Eason Chan) - "人啊人 (HOMO SAPIENS)"
Hunxho - "Rockstar Lifestyle"
Jenny Hval - "Buffy"
​joan - "flowers"
K.Flay - "It's Been So Long"
Key Glock - "Jigsaw"
Röyksopp - "Stay Awhile" ft. Susanne Sundfør
Smokepurpp - "Shoot First"
Weathers - "Where Do I Sign?"
Weyes Blood - "God Turn Me Into a Flower"
11/17
Antt Beatz, DJ Drama & Tee Grizzley - "Thanksgiving"
Chanell & De La Rose - "Nena Buena"
Comethazine - "Grab1 Get1 Pick1"
Emilia - "Underground"
ENNY & Unknown T - "Champagne Problems (Remix)"
Foogiano & Gucci Mane "Slicin"
Gorillaz - "New Gold (Dom Dolla Remix)" ft. Tame Impala & Bootie Brown
Jack River - "Nothing Has Changed"
JP Saxe - "The Good Parts"
KEiiNO - "Nights of Thunder"
Kimbra - "replay!"
Naaz - "Daughter"
paopao, Ingratax & FMK - "cuenta (remix)"
Quando Rondo & YoungBoy Never Broke Again - "Keep Me Dry"
Rich Brian - "VIVID" ft. $NOT
Saweetie - "DON'T SAY NOTHIN'"
Xcelencia - "3AM"
Young Dolph - "Get Away"
Zion & Lennox - "WAYO"
11/18
21 Lil Harold - "Damn" ft. G Herbo
Ab-Soul - "Gang'Nem" ft. Fre$H
AJR - "The DJ Is Crying For Help"
Alan Walker & UPSAHL - "Shut Up"
Ashley Cooke - "​​​dirt on 'em"
Ashley Cooke - ​"running back"
Babyface Ray, Blxst & Nija - "Spend it"
BANNERS - "Easy"
Bright Light Bright Light - "I Don't Know What I'm Gonna Do"
Bryce Vine - "Help" ft. Pheelz
brakence - "bugging!"
Cheat Codes - "One Night Left" ft. MacKenzie Porter
Chris Brown - "It's Giving Christmas"
Chris Brown - "No Time Like Christmas"
Chxrry22 - "Sacrifice"
Dave East - "Dope Boy"
Devin Morrison - "P.B.J."
Dierks Bentley - "High Note" ft. Billy Strings
Don Toliver - "Do It Right"
DSTRCT - "O.T."
ELENA ROSE - "Bayamón"
Elton John & Britney Spears - "Hold Me Closer (Acoustic)"
EMELINE - "Venting to Strangers"
Eric Bellinger - "Obsession (Remix)" ft. Muni Long
Fetty Wap - "Sweet Yamz"
Flo Rida, Walker Hayes & Aukoustics - "High Heels (Whistle While You Twerk)" ft. Secs on the beach
Gabrielle Aplin - "Don't Say"
Greyson Chance - "I'll Be Home For Christmas"
Jahmiel - "Fade Away"
Jazmin Bean - "Carnage" ft. Lucy Loone
Joey Montana & El Zeta - "QUIÉN SABE"
Jubël - "My Only Wish" ft. Christopher
JVKE - "golden hour (Ruel Remix)"
Kate Stewart - "London Town"
Kid Ink & Wiz Khalifa - "Big Burna"
Kygo, Gryffin & Calum Scott - "Woke Up in Love (Alok Remix)"
Lauren Spencer-Smith - "Single On The 25th"
Mac Critter - "DAWG" ft. Gucci Mane
Morray - "Broken Vows"
Nakkia Gold - "Nowhere"
Nicki Minaj, Maluma & Myriam Fares - "Tukoh Taka (Official FFF Anthem)" ft. FIFA Sound
Noah Cyrus & P.J. Harding - "Snow in LA"
Oriana - "CHIN CHIN"
Peezy, Jeezy & Rich Boston Richey - "2 Million Up" ft. Rob49
Pharrell Williams & Travis Scott - "Down in Atlanta"
quinnie - "​​silver bells"
quinnie - "​silver second"
R3HAB & Andy Grammer - "Good Example (R3hab Vip Remix)"
Rhys Lewis - "Christmas Eve"
Rileyy Lanez - "Not Mine"
Rowan Drake - "Hollow"
Sam Smith - "Night Before Christmas"
Seeb & Alexander Stewart - "Would You Lie"
Sharlene - "Desorden"
Tayla Parx - "For What It's Worth"
The Vamps - "Seat At The Table"
Thomas Day - "The End"
Valencia Grace - "Final Dance"
VEDO - "FOREVER"
vf7 - "La Bori"
Vintage Culture - "Agape"
Vitão - "Quando" ft. Russ
顧定軒 (Zeno Koo) - "教我 (Teach Me)"
11/19
Leebada - "I Warn You"
11/22
陳蕾 & 岑寧兒 (Panther Chan & Yoyo Sham) - "言之無物 (Fully Empty)"
YoungBoy Never Broke Again - "Hi Haters"
11/23
Lili-Ann De Francesco - "Touch" ft. johan lenox
Sam Hunt - "Start Nowhere"
11/24
wifisfuneral - "1 AM"

11/25
Aitch, Ashanti & Hamza - "Baby (Remix)"
Alan Walker - "Ritual"
Ali Gatie - "Scared of Love"
Anti Da Menace & Rob49 - "Blood Boy"
Armin van Buuren & Wildstylez - "Typically Dutch" ft. PollyAnna
Groundbreaking - "Dead Ends"
Jer 柳應廷 - "坐看雲起時 (Watching the Clouds Rise)"
KATO2X - "Still In A Warzone"
Lansdowne - "Halo"
Lil PJ - "Dead Opps" ft. Lil Double 0
MC 張天賦 (Cheung Tinfu) - "Overkill"
Olly Murs - "I Hate You When You’re Drunk"
Owl City - "Up To The Cloud"
Tone Stith - "B.E.D"
YNS Flow - "FTW"
YNW BSlime - "Keep Trying" ft. BabyTron

11/26
IRIS - "IRIS Main Theme (We Stand in Line)"
11/27
Shawn Christmas - "lost"
11/28
Metallica - "Lux Æterna"
Pheelz - "Finesse (Remix)" ft. French Montana
Pheelz - "Finesse (Bounty Killer Remix)" ft. Bounty Killer

11/29
Circa Waves - "Carry You Home"
Gabbie Hanna - "Haircut"
Nas & 21 Savage - "One Mic, One Gun"
Vistas - "My Head Feels Strange"
11/30
許廷鏗 & 楊安妮 (Alfred Hui & WinWin) - "假面具 (Masquerade)"
Aayanna - "Risky"
Coi Leray - "Players"
Lloyiso - "Let Me Love You Now"
Mac Critter - "Burst"
PinkPantheress - "Boy's a liar"
Popcaan - "Next To Me" ft. Toni-Ann Singh
Rusherking - "El Plan" ft. Emilia, L-Gante
Saucy Santana - "Bop Bop"
Sheck Wes - "PAIN!"
SoulJase - "日月如梭 (To Artemis)"
Wallice - "Japan"
whenyoung - "Unchained"1