Selena Gomez - Single Soon
Miley Cyrus - Used To Be Young
BLACKPINK - THE GIRLS
Victoria MonÃ©t - Alright
Burna Boy - City Boys
Brent Faiyaz - Moment Of Your Life
Conan Gray - Winner
Gucci Mane - There I Go (feat. J. Cole & Mike WiLL Made-It)
Lil Yachty - TESLA
John Summit - Fade Out (feat. MKLA)
Maluma & Yandel - Trofeo
Feid & ICON - FERXXO 151
French Montana & Swae Lee - Wish U Well (Extended)
Dave & Tiakola - Meridian
Omar Apollo - Ice Slippin
Zach Bryan - Tourniquet
The Killers - Your Side of Town
Morgan Wade - 27 Club
Charlotte Cardin - Daddy's a Psycho
Laufey - California and Me
Fuerza Regida - La Tierra del Corrido - Spotify Singles
Mitski - Heaven
Sid Sriram - Quiet Storm
Jordan Ward - ZOOMIES
Burna Boy - Cheat On Me (feat. Dave)
Tyga - PARTy T1M3
City Girls - Face Down
Peezy & Key Glock - No Amiris
Yung Gravy - No Way Jose
Ashnikko - Dying Star (feat. Ethel Cain)
YUNGBLUD - Hated
Manuel Turizo & Grupo Frontera - DE LUNES A LUNES
Charlotte Day Wilson & Snoh Aalegra - Forever
Tim McGraw - Hold On To It
GAYLE - leave me for dead
Jason Derulo - Body Count
BETWEEN FRIENDS - Self destruct
hemlocke springs - enknee1
Toro y Moi - Sidelines
Dan + Shay - We Should Get Married
Yeek - Care (feat. Bakar)
Blessd, Peso Pluma & SOG - Ojos Azules
Paul Dally - Moonlit Breakers (feat. Dijon)
Ashley Kutcher - Matchbox
Joel Corry, MK & Rita Ora - Drinkin'
Robin Schulz - One with the Wolves
The Chemical Brothers - Skipping Like A Stone (feat. Beck)
Cuco & AlemÃ¡n - Coastin'
Naomi Sharon - Definition of Love
Earl Sweatshirt & The Alchemist - Sentry (feat. MIKE)
Luh Tyler - Rapper of the Year
Asking Alexandria - Let Go
ONE OK ROCK - Make It Out Alive
VIC MENSA - Blue Eyes
The Beaches - What Doesn't Kill You Makes You Paranoid
Digga D - Kindness For Weakness
Yung Lean - Victorious
Connor Price - Let Go
Brooke Alexx - Never Liked Your Name
Madeline The Person - Tantrum
Natalie Jane - Do or Die
Jenna Raine - Cruise Control
Turnpike Troubadours - A Cat in the Rain
Derek Minor - Third Day (feat. Ty Brasel)ðŸ•’
Chxrry22 - More
Fridayy - Stand By Me
Tai Verdes - All White
Kirk Franklin - Try Love
BRELAND - Cowboy Don't
Black Pumas - More Than a Love Song
1nonly - POPTHATRUNK
Spiritbox - Jaded
Darci - Off A Cliff (With Reo Cragun)
Eli Brown - Diamonds On My Mind
Mochakk - JealousðŸ•’
Sans Soucis - Lost When I'm Around You
Hiss Golden Messenger - The Wondering
Slow Pulp - Broadview
Say She She - Echo In The ChamberðŸ•’
Buck Meek - Didn't Know You Then
slimdan - Celebrity Lookalikes
L'Rain - Pet Rock
Jason Aldean - Let Your Boys Be Country
Patrick Droney - Shotgun Rider
Lexi Jayde - bandages
A R I Z O N A - Hanging On
Frawley - Figure You Out
Rundown Spaz & Rundown Choppaboy - Murda Twins
Sauce Walka & Peezy - Uh Uh
AUDREY NUNA - locket
Carver Jones - JEANS
Anish Kumar - Marabelle
Gareth Donkin - Falling For You
Kyle Dion - Boyfriend Jeans
ISOxo & Ninajirachi - SHYPOP
TOBi - Flatline (feat. Kenny Mason)
Ben Reilly - Yondu
Casper Sage - U4EA
The Armed - Modern Vanity